Id,Id2,Geography,Estimate; Total:,Estimate; Not Hispanic or Latino:,Estimate; Not Hispanic or Latino: - White alone,Estimate; Not Hispanic or Latino: - Black or African American alone,Estimate; Not Hispanic or Latino: - American Indian and Alaska Native alone,Estimate; Not Hispanic or Latino: - Asian alone,Estimate; Not Hispanic or Latino: - Native Hawaiian and Other Pacific Islander alone,Estimate; Not Hispanic or Latino: - Some other race alone,Estimate; Not Hispanic or Latino: - Two or more races:,Estimate; Not Hispanic or Latino: - Two or more races: - Two races including Some other race,"Estimate; Not Hispanic or Latino: - Two or more races: - Two races excluding Some other race, and three or more races",Estimate; Hispanic or Latino:,Estimate; Hispanic or Latino: - White alone,Estimate; Hispanic or Latino: - Black or African American alone,Estimate; Hispanic or Latino: - American Indian and Alaska Native alone,Estimate; Hispanic or Latino: - Asian alone,Estimate; Hispanic or Latino: - Native Hawaiian and Other Pacific Islander alone,Estimate; Hispanic or Latino: - Some other race alone,Estimate; Hispanic or Latino: - Two or more races:,Estimate; Hispanic or Latino: - Two or more races: - Two races including Some other race,"Estimate; Hispanic or Latino: - Two or more races: - Two races excluding Some other race, and three or more races",Non_NonHWhite
1400000US17031010100,17031010100,"Census Tract 101, Cook County, Illinois",4189,3733,1754,1628,0,162,0,15,174,19,155,456,319,59,0,0,0,78,0,0,0,0.581284316
1400000US17031010201,17031010201,"Census Tract 102.01, Cook County, Illinois",7083,5512,1734,3545,16,148,0,10,59,0,59,1571,1464,0,0,0,0,31,76,38,38,0.755188479
1400000US17031010202,17031010202,"Census Tract 102.02, Cook County, Illinois",2502,1844,744,800,0,239,0,0,61,17,44,658,355,39,6,9,18,208,23,23,0,0.70263789
1400000US17031010300,17031010300,"Census Tract 103, Cook County, Illinois",6213,5249,2730,1715,5,741,0,0,58,0,58,964,699,91,0,0,0,148,26,20,6,0.560598745
1400000US17031010400,17031010400,"Census Tract 104, Cook County, Illinois",4730,4276,3112,615,0,385,0,35,129,37,92,454,315,45,0,10,0,58,26,12,14,0.342071882
1400000US17031010501,17031010501,"Census Tract 105.01, Cook County, Illinois",3831,3640,2156,1190,0,100,0,0,194,0,194,191,174,0,0,0,0,17,0,0,0,0.437222657
1400000US17031010502,17031010502,"Census Tract 105.02, Cook County, Illinois",3690,3112,1918,492,0,638,0,0,64,24,40,578,205,103,0,0,0,246,24,0,24,0.480216802
1400000US17031010503,17031010503,"Census Tract 105.03, Cook County, Illinois",2228,1854,1254,178,0,326,0,0,96,39,57,374,323,39,0,0,0,12,0,0,0,0.437163375
1400000US17031010600,17031010600,"Census Tract 106, Cook County, Illinois",6513,4798,2642,1859,0,106,0,16,175,0,175,1715,1445,51,4,0,0,71,144,0,144,0.594349762
1400000US17031010701,17031010701,"Census Tract 107.01, Cook County, Illinois",3946,2292,1357,624,0,200,0,13,98,0,98,1654,1208,31,0,0,0,399,16,0,16,0.656107451
1400000US17031010702,17031010702,"Census Tract 107.02, Cook County, Illinois",5274,2620,1093,1077,0,244,0,36,170,0,170,2654,1885,0,0,0,0,688,81,0,81,0.792756921
1400000US17031020100,17031020100,"Census Tract 201, Cook County, Illinois",3990,3501,1410,1129,0,808,0,31,123,0,123,489,387,8,0,11,0,83,0,0,0,0.646616541
1400000US17031020200,17031020200,"Census Tract 202, Cook County, Illinois",6255,5673,4112,286,0,1170,0,0,105,0,105,582,424,0,0,0,0,158,0,0,0,0.342605915
1400000US17031020301,17031020301,"Census Tract 203.01, Cook County, Illinois",5239,4887,4016,280,37,498,0,10,46,14,32,352,352,0,0,0,0,0,0,0,0,0.233441496
1400000US17031020302,17031020302,"Census Tract 203.02, Cook County, Illinois",4651,3767,2417,543,0,774,0,0,33,0,33,884,622,0,0,7,0,245,10,10,0,0.480326811
1400000US17031020400,17031020400,"Census Tract 204, Cook County, Illinois",4294,3335,1886,753,0,600,0,43,53,18,35,959,604,0,107,0,0,248,0,0,0,0.560782487
1400000US17031020500,17031020500,"Census Tract 205, Cook County, Illinois",6004,4084,1495,1025,0,1191,6,15,352,32,320,1920,1119,230,0,0,0,571,0,0,0,0.750999334
1400000US17031020601,17031020601,"Census Tract 206.01, Cook County, Illinois",6697,5714,3657,346,44,1418,0,75,174,66,108,983,467,75,3,83,0,222,133,46,87,0.453934598
1400000US17031020602,17031020602,"Census Tract 206.02, Cook County, Illinois",4102,3041,1340,325,0,1220,0,62,94,34,60,1061,684,17,0,0,0,259,101,0,101,0.673330083
1400000US17031020701,17031020701,"Census Tract 207.01, Cook County, Illinois",1893,1625,1035,153,78,280,0,0,79,68,11,268,209,0,6,0,0,37,16,16,0,0.453248811
1400000US17031020702,17031020702,"Census Tract 207.02, Cook County, Illinois",8232,7134,3962,212,0,2635,0,0,325,127,198,1098,763,36,18,0,0,152,129,92,37,0.518707483
1400000US17031020801,17031020801,"Census Tract 208.01, Cook County, Illinois",4512,3143,1927,186,0,682,0,0,348,34,314,1369,752,35,0,0,0,582,0,0,0,0.572916667
1400000US17031020802,17031020802,"Census Tract 208.02, Cook County, Illinois",7942,6534,2054,591,0,3793,0,0,96,0,96,1408,896,0,0,0,0,512,0,0,0,0.741374969
1400000US17031020901,17031020901,"Census Tract 209.01, Cook County, Illinois",5013,3730,1391,1034,0,1215,0,0,90,0,90,1283,1039,0,0,0,0,244,0,0,0,0.722521444
1400000US17031020902,17031020902,"Census Tract 209.02, Cook County, Illinois",4195,3763,2137,781,0,813,0,0,32,0,32,432,414,0,0,0,0,18,0,0,0,0.490584029
1400000US17031030101,17031030101,"Census Tract 301.01, Cook County, Illinois",3727,2916,1765,746,0,248,0,49,108,0,108,811,529,0,8,0,0,274,0,0,0,0.526428763
1400000US17031030102,17031030102,"Census Tract 301.02, Cook County, Illinois",2956,2552,1520,579,51,332,0,0,70,0,70,404,270,0,0,15,0,79,40,40,0,0.48579161
1400000US17031030103,17031030103,"Census Tract 301.03, Cook County, Illinois",2238,1879,1146,297,4,387,0,0,45,15,30,359,141,48,0,0,0,170,0,0,0,0.487935657
1400000US17031030104,17031030104,"Census Tract 301.04, Cook County, Illinois",3688,3393,1768,566,0,694,0,59,306,58,248,295,205,0,0,16,27,38,9,9,0,0.520607375
1400000US17031030200,17031030200,"Census Tract 302, Cook County, Illinois",5274,4418,3730,482,1,161,0,0,44,0,44,856,663,0,0,9,0,149,35,0,35,0.292756921
1400000US17031030300,17031030300,"Census Tract 303, Cook County, Illinois",3049,1777,1125,343,0,270,0,0,39,16,23,1272,869,0,80,8,0,315,0,0,0,0.631026566
1400000US17031030400,17031030400,"Census Tract 304, Cook County, Illinois",2683,1796,1266,339,0,150,0,0,41,7,34,887,650,0,0,9,0,180,48,31,17,0.528140142
1400000US17031030500,17031030500,"Census Tract 305, Cook County, Illinois",6269,4525,3574,400,0,453,0,0,98,0,98,1744,1378,0,0,60,0,268,38,38,0,0.429893125
1400000US17031030601,17031030601,"Census Tract 306.01, Cook County, Illinois",3538,2993,1820,747,0,346,0,23,57,29,28,545,538,0,0,0,0,7,0,0,0,0.485585076
1400000US17031030603,17031030603,"Census Tract 306.03, Cook County, Illinois",2048,1919,760,831,0,295,0,0,33,0,33,129,88,0,0,0,0,32,9,9,0,0.62890625
1400000US17031030604,17031030604,"Census Tract 306.04, Cook County, Illinois",2961,2870,1504,647,0,647,0,15,57,13,44,91,74,17,0,0,0,0,0,0,0,0.492063492
1400000US17031030701,17031030701,"Census Tract 307.01, Cook County, Illinois",1734,1649,860,347,0,310,0,0,132,0,132,85,30,19,0,0,0,4,32,0,32,0.504036909
1400000US17031030702,17031030702,"Census Tract 307.02, Cook County, Illinois",1460,1432,1112,98,0,222,0,0,0,0,0,28,25,3,0,0,0,0,0,0,0,0.238356164
1400000US17031030703,17031030703,"Census Tract 307.03, Cook County, Illinois",2579,2429,1662,344,0,267,0,19,137,25,112,150,94,17,0,0,0,10,29,0,29,0.355564172
1400000US17031030706,17031030706,"Census Tract 307.06, Cook County, Illinois",3460,3175,1899,522,0,641,0,0,113,0,113,285,186,0,0,0,0,95,4,4,0,0.451156069
1400000US17031030800,17031030800,"Census Tract 308, Cook County, Illinois",4405,3861,2780,145,0,610,0,0,326,3,323,544,469,0,0,0,0,62,13,0,13,0.368898978
1400000US17031030900,17031030900,"Census Tract 309, Cook County, Illinois",3207,2685,1860,252,0,449,0,6,118,0,118,522,269,26,6,80,0,127,14,14,0,0.420018709
1400000US17031031000,17031031000,"Census Tract 310, Cook County, Illinois",3522,3010,2287,148,0,345,0,42,188,0,188,512,359,0,0,0,0,147,6,0,6,0.350653038
1400000US17031031100,17031031100,"Census Tract 311, Cook County, Illinois",4136,3454,2794,241,7,292,0,14,106,0,106,682,368,0,0,0,0,311,3,3,0,0.324468085
1400000US17031031200,17031031200,"Census Tract 312, Cook County, Illinois",4860,4247,2173,1587,30,421,0,0,36,0,36,613,437,14,67,0,21,42,32,14,18,0.552880658
1400000US17031031300,17031031300,"Census Tract 313, Cook County, Illinois",7543,6663,3037,1769,13,1498,0,0,346,40,306,880,666,105,0,0,0,93,16,0,16,0.59737505
1400000US17031031400,17031031400,"Census Tract 314, Cook County, Illinois",5260,4748,3512,595,0,327,0,39,275,0,275,512,421,17,0,0,0,57,17,17,0,0.332319392
1400000US17031031501,17031031501,"Census Tract 315.01, Cook County, Illinois",3430,3233,1336,1032,0,786,0,20,59,22,37,197,113,0,0,0,0,79,5,5,0,0.610495627
1400000US17031031502,17031031502,"Census Tract 315.02, Cook County, Illinois",4386,3652,1225,1863,10,265,0,0,289,0,289,734,524,115,0,0,0,95,0,0,0,0.720702234
1400000US17031031700,17031031700,"Census Tract 317, Cook County, Illinois",6525,5539,3436,1442,0,447,0,0,214,0,214,986,513,68,0,0,0,405,0,0,0,0.473409962
1400000US17031031800,17031031800,"Census Tract 318, Cook County, Illinois",1717,1377,1156,17,18,179,0,0,7,4,3,340,326,4,0,0,0,10,0,0,0,0.326732673
1400000US17031031900,17031031900,"Census Tract 319, Cook County, Illinois",2355,2129,1753,182,24,100,0,52,18,0,18,226,135,0,0,0,0,91,0,0,0,0.255626327
1400000US17031032100,17031032100,"Census Tract 321, Cook County, Illinois",6767,5992,4633,778,0,522,0,4,55,0,55,775,539,0,0,0,0,208,28,0,28,0.315353923
1400000US17031040100,17031040100,"Census Tract 401, Cook County, Illinois",3998,3273,2678,173,83,288,0,0,51,0,51,725,510,60,0,0,0,140,15,0,15,0.330165083
1400000US17031040201,17031040201,"Census Tract 402.01, Cook County, Illinois",6195,5125,4254,39,0,690,0,0,142,25,117,1070,709,0,0,0,0,361,0,0,0,0.313317191
1400000US17031040202,17031040202,"Census Tract 402.02, Cook County, Illinois",6691,5645,3337,491,0,1636,0,10,171,0,171,1046,566,16,0,0,0,394,70,12,58,0.501270363
1400000US17031040300,17031040300,"Census Tract 403, Cook County, Illinois",2656,2382,1586,73,34,555,0,0,134,45,89,274,221,0,0,0,0,15,38,30,8,0.402861446
1400000US17031040401,17031040401,"Census Tract 404.01, Cook County, Illinois",2836,2293,1837,165,15,206,0,0,70,0,70,543,185,1,9,0,0,310,38,9,29,0.3522567
1400000US17031040402,17031040402,"Census Tract 404.02, Cook County, Illinois",4701,3931,3001,153,0,618,0,0,159,0,159,770,714,0,0,42,0,14,0,0,0,0.361625186
1400000US17031040600,17031040600,"Census Tract 406, Cook County, Illinois",2684,2314,2130,61,0,109,0,0,14,0,14,370,264,0,0,0,0,106,0,0,0,0.206408346
1400000US17031040700,17031040700,"Census Tract 407, Cook County, Illinois",3353,2475,2142,117,0,175,0,0,41,0,41,878,723,0,0,9,0,140,6,0,6,0.361169102
1400000US17031040800,17031040800,"Census Tract 408, Cook County, Illinois",1815,1661,1332,60,38,163,0,0,68,0,68,154,101,0,15,0,0,29,9,0,9,0.266115702
1400000US17031040900,17031040900,"Census Tract 409, Cook County, Illinois",2118,1926,1798,2,0,73,0,0,53,0,53,192,163,0,0,0,0,29,0,0,0,0.15108593
1400000US17031050100,17031050100,"Census Tract 501, Cook County, Illinois",2406,2034,1848,43,0,107,0,0,36,0,36,372,329,0,0,0,0,30,13,0,13,0.2319202
1400000US17031050200,17031050200,"Census Tract 502, Cook County, Illinois",5120,4007,3605,111,0,200,0,0,91,0,91,1113,996,49,0,0,0,68,0,0,0,0.295898438
1400000US17031050300,17031050300,"Census Tract 503, Cook County, Illinois",2566,2031,1787,0,26,180,0,0,38,7,31,535,439,18,0,9,0,0,69,0,69,0.303585347
1400000US17031050500,17031050500,"Census Tract 505, Cook County, Illinois",5365,4793,4317,48,0,113,0,0,315,0,315,572,468,0,0,0,0,86,18,0,18,0.195340168
1400000US17031050600,17031050600,"Census Tract 506, Cook County, Illinois",2414,2174,1969,45,0,149,0,0,11,0,11,240,217,0,0,0,0,11,12,12,0,0.184341342
1400000US17031050700,17031050700,"Census Tract 507, Cook County, Illinois",1753,1671,1589,15,0,41,0,4,22,5,17,82,72,0,0,0,0,10,0,0,0,0.093553908
1400000US17031050800,17031050800,"Census Tract 508, Cook County, Illinois",1427,1323,1259,12,0,23,0,0,29,0,29,104,104,0,0,0,0,0,0,0,0,0.117729502
1400000US17031050900,17031050900,"Census Tract 509, Cook County, Illinois",1660,1547,1404,0,0,109,0,10,24,0,24,113,89,0,0,0,0,24,0,0,0,0.154216867
1400000US17031051000,17031051000,"Census Tract 510, Cook County, Illinois",1610,1355,1175,29,0,115,0,0,36,0,36,255,175,0,0,0,0,80,0,0,0,0.270186335
1400000US17031051100,17031051100,"Census Tract 511, Cook County, Illinois",1526,1287,1169,29,0,38,0,0,51,0,51,239,177,0,0,0,0,62,0,0,0,0.233944954
1400000US17031051200,17031051200,"Census Tract 512, Cook County, Illinois",1562,1392,1222,115,7,36,0,0,12,0,12,170,130,0,0,0,0,0,40,36,4,0.217669654
1400000US17031051300,17031051300,"Census Tract 513, Cook County, Illinois",2953,2624,2413,52,0,70,0,12,77,0,77,329,284,0,0,0,0,28,17,0,17,0.182864883
1400000US17031051400,17031051400,"Census Tract 514, Cook County, Illinois",2174,1891,1609,74,0,39,0,0,169,0,169,283,223,0,0,0,0,43,17,13,4,0.259889604
1400000US17031060100,17031060100,"Census Tract 601, Cook County, Illinois",2596,2384,2126,206,0,17,0,0,35,16,19,212,167,0,0,0,0,29,16,0,16,0.181047766
1400000US17031060200,17031060200,"Census Tract 602, Cook County, Illinois",2126,1822,1592,59,0,159,0,0,12,0,12,304,290,0,0,0,0,14,0,0,0,0.251175917
1400000US17031060300,17031060300,"Census Tract 603, Cook County, Illinois",3176,3039,2870,9,6,154,0,0,0,0,0,137,137,0,0,0,0,0,0,0,0,0.096347607
1400000US17031060400,17031060400,"Census Tract 604, Cook County, Illinois",4003,3576,3343,16,42,111,0,0,64,0,64,427,396,0,10,0,0,12,9,0,9,0.164876343
1400000US17031060500,17031060500,"Census Tract 605, Cook County, Illinois",1235,1091,842,74,10,136,0,0,29,0,29,144,135,0,0,0,0,4,5,5,0,0.318218623
1400000US17031060800,17031060800,"Census Tract 608, Cook County, Illinois",4840,4630,3746,253,0,570,0,0,61,0,61,210,101,28,0,0,0,81,0,0,0,0.226033058
1400000US17031060900,17031060900,"Census Tract 609, Cook County, Illinois",6758,5861,4768,321,127,320,0,0,325,0,325,897,750,9,0,0,0,138,0,0,0,0.294465818
1400000US17031061000,17031061000,"Census Tract 610, Cook County, Illinois",1716,1452,1189,25,0,184,0,25,29,0,29,264,239,0,0,0,0,6,19,19,0,0.307109557
1400000US17031061100,17031061100,"Census Tract 611, Cook County, Illinois",1309,1267,1169,27,6,65,0,0,0,0,0,42,36,0,6,0,0,0,0,0,0,0.106951872
1400000US17031061200,17031061200,"Census Tract 612, Cook County, Illinois",2235,2133,1860,29,0,139,0,0,105,0,105,102,71,0,9,0,0,22,0,0,0,0.167785235
1400000US17031061500,17031061500,"Census Tract 615, Cook County, Illinois",1859,1740,1618,9,0,62,0,0,51,0,51,119,87,0,0,0,0,32,0,0,0,0.129639591
1400000US17031061800,17031061800,"Census Tract 618, Cook County, Illinois",1130,1006,849,33,0,106,0,6,12,0,12,124,106,0,0,0,4,14,0,0,0,0.248672566
1400000US17031061901,17031061901,"Census Tract 619.01, Cook County, Illinois",3785,3332,2798,147,12,323,13,21,18,0,18,453,319,0,0,0,0,104,30,16,14,0.260766182
1400000US17031061902,17031061902,"Census Tract 619.02, Cook County, Illinois",4045,3829,3212,196,0,310,0,0,111,0,111,216,91,0,0,58,0,27,40,16,24,0.205933251
1400000US17031062000,17031062000,"Census Tract 620, Cook County, Illinois",2897,2791,2347,153,0,180,0,0,111,0,111,106,86,0,0,0,0,20,0,0,0,0.189851571
1400000US17031062100,17031062100,"Census Tract 621, Cook County, Illinois",3372,3147,2855,22,0,226,0,0,44,9,35,225,178,0,0,0,0,47,0,0,0,0.153321471
1400000US17031062200,17031062200,"Census Tract 622, Cook County, Illinois",2987,2827,2515,106,0,146,0,0,60,0,60,160,109,0,0,0,0,51,0,0,0,0.158018078
1400000US17031062300,17031062300,"Census Tract 623, Cook County, Illinois",1716,1645,1508,6,0,83,0,0,48,0,48,71,65,0,0,0,0,6,0,0,0,0.121212121
1400000US17031062400,17031062400,"Census Tract 624, Cook County, Illinois",1622,1537,1437,30,0,58,0,0,12,0,12,85,66,0,0,0,0,19,0,0,0,0.11405672
1400000US17031062500,17031062500,"Census Tract 625, Cook County, Illinois",1342,1282,1180,0,0,69,0,0,33,0,33,60,54,0,0,0,0,6,0,0,0,0.12071535
1400000US17031062600,17031062600,"Census Tract 626, Cook County, Illinois",2281,1988,1708,21,0,178,0,0,81,0,81,293,254,0,0,0,0,6,33,33,0,0.251205612
1400000US17031062700,17031062700,"Census Tract 627, Cook County, Illinois",2757,2582,2414,16,0,39,0,0,113,0,113,175,54,0,0,0,0,110,11,11,0,0.124410591
1400000US17031062800,17031062800,"Census Tract 628, Cook County, Illinois",3792,3466,3089,148,0,155,0,0,74,0,74,326,278,0,0,8,0,40,0,0,0,0.185390295
1400000US17031062900,17031062900,"Census Tract 629, Cook County, Illinois",4176,4036,3672,11,0,255,0,0,98,0,98,140,123,0,0,0,0,17,0,0,0,0.120689655
1400000US17031063000,17031063000,"Census Tract 630, Cook County, Illinois",3055,2767,2384,68,0,180,0,0,135,35,100,288,210,11,14,0,0,46,7,0,7,0.219639935
1400000US17031063100,17031063100,"Census Tract 631, Cook County, Illinois",2399,2213,1900,0,0,164,0,5,144,0,144,186,129,0,0,0,0,57,0,0,0,0.208003335
1400000US17031063200,17031063200,"Census Tract 632, Cook County, Illinois",6580,6405,5177,247,0,864,0,29,88,3,85,175,111,0,0,0,0,18,46,0,46,0.213221884
1400000US17031063301,17031063301,"Census Tract 633.01, Cook County, Illinois",2626,2453,1872,267,0,244,0,0,70,0,70,173,173,0,0,0,0,0,0,0,0,0.287128713
1400000US17031063302,17031063302,"Census Tract 633.02, Cook County, Illinois",4186,4006,3358,68,0,491,0,26,63,0,63,180,148,0,0,20,0,12,0,0,0,0.197802198
1400000US17031063303,17031063303,"Census Tract 633.03, Cook County, Illinois",1157,1107,1036,27,0,39,0,0,5,0,5,50,40,0,0,0,0,0,10,0,10,0.104580812
1400000US17031063400,17031063400,"Census Tract 634, Cook County, Illinois",2158,1992,1754,93,0,92,0,0,53,0,53,166,166,0,0,0,0,0,0,0,0,0.18721038
1400000US17031070101,17031070101,"Census Tract 701.01, Cook County, Illinois",3988,3951,3527,96,0,188,0,0,140,0,140,37,37,0,0,0,0,0,0,0,0,0.11559679
1400000US17031070102,17031070102,"Census Tract 701.02, Cook County, Illinois",2656,2329,1881,216,0,196,0,8,28,0,28,327,276,0,0,0,0,51,0,0,0,0.291792169
1400000US17031070103,17031070103,"Census Tract 701.03, Cook County, Illinois",1679,1556,1395,76,0,85,0,0,0,0,0,123,117,0,0,0,0,6,0,0,0,0.169148303
1400000US17031070200,17031070200,"Census Tract 702, Cook County, Illinois",3937,3665,3118,184,0,285,0,0,78,0,78,272,208,0,0,0,0,62,2,2,0,0.208026416
1400000US17031070300,17031070300,"Census Tract 703, Cook County, Illinois",3383,3243,2710,56,0,310,0,69,98,0,98,140,133,0,0,0,0,7,0,0,0,0.198935856
1400000US17031070400,17031070400,"Census Tract 704, Cook County, Illinois",3440,3154,2907,132,0,87,0,0,28,0,28,286,254,0,0,0,0,32,0,0,0,0.15494186
1400000US17031070500,17031070500,"Census Tract 705, Cook County, Illinois",3022,2792,2598,109,0,53,0,0,32,0,32,230,129,0,34,0,0,67,0,0,0,0.140304434
1400000US17031070600,17031070600,"Census Tract 706, Cook County, Illinois",3083,2743,2609,39,0,64,0,0,31,0,31,340,340,0,0,0,0,0,0,0,0,0.153746351
1400000US17031070700,17031070700,"Census Tract 707, Cook County, Illinois",3983,3322,2880,17,0,376,0,0,49,0,49,661,511,0,0,0,0,142,8,0,8,0.276926939
1400000US17031071000,17031071000,"Census Tract 710, Cook County, Illinois",4277,3859,3253,142,0,335,0,6,123,12,111,418,345,6,3,0,0,56,8,8,0,0.239420154
1400000US17031071100,17031071100,"Census Tract 711, Cook County, Illinois",2932,2832,2534,97,0,93,4,11,93,13,80,100,84,0,4,6,0,0,6,0,6,0.13574352
1400000US17031071200,17031071200,"Census Tract 712, Cook County, Illinois",2016,1800,1472,73,0,220,0,0,35,0,35,216,216,0,0,0,0,0,0,0,0,0.26984127
1400000US17031071300,17031071300,"Census Tract 713, Cook County, Illinois",3414,3301,2914,109,0,235,15,0,28,0,28,113,113,0,0,0,0,0,0,0,0,0.14645577
1400000US17031071400,17031071400,"Census Tract 714, Cook County, Illinois",4357,4116,3553,171,0,262,0,0,130,0,130,241,157,0,0,0,0,57,27,14,13,0.18453064
1400000US17031071500,17031071500,"Census Tract 715, Cook County, Illinois",5710,5403,4661,186,0,421,0,45,90,0,90,307,237,0,0,0,0,32,38,38,0,0.183712785
1400000US17031071600,17031071600,"Census Tract 716, Cook County, Illinois",1715,1666,1436,75,0,56,0,4,95,8,87,49,43,0,0,0,0,6,0,0,0,0.162682216
1400000US17031071700,17031071700,"Census Tract 717, Cook County, Illinois",1813,1663,1282,251,8,99,0,5,18,6,12,150,128,11,0,0,0,11,0,0,0,0.292884721
1400000US17031071800,17031071800,"Census Tract 718, Cook County, Illinois",2670,2536,2096,319,0,65,0,0,56,0,56,134,123,0,0,0,0,11,0,0,0,0.214981273
1400000US17031080100,17031080100,"Census Tract 801, Cook County, Illinois",6657,6336,5793,243,0,178,0,0,122,0,122,321,203,72,0,0,0,29,17,0,17,0.129788193
1400000US17031080201,17031080201,"Census Tract 802.01, Cook County, Illinois",3235,3209,2949,131,37,34,0,10,48,21,27,26,0,0,0,0,0,26,0,0,0,0.088408037
1400000US17031080202,17031080202,"Census Tract 802.02, Cook County, Illinois",3533,3451,3021,109,0,310,0,0,11,0,11,82,82,0,0,0,0,0,0,0,0,0.144919332
1400000US17031080300,17031080300,"Census Tract 803, Cook County, Illinois",4480,4332,3494,349,0,386,0,41,62,0,62,148,140,0,0,0,0,8,0,0,0,0.220089286
1400000US17031080400,17031080400,"Census Tract 804, Cook County, Illinois",4907,4785,1786,2716,83,95,0,0,105,0,105,122,0,111,0,0,0,0,11,11,0,0.636030161
1400000US17031081000,17031081000,"Census Tract 810, Cook County, Illinois",7427,6947,5273,710,0,863,0,48,53,16,37,480,232,0,0,15,0,176,57,57,0,0.290022889
1400000US17031081100,17031081100,"Census Tract 811, Cook County, Illinois",3657,3388,2763,365,0,156,0,0,104,0,104,269,129,0,0,0,0,140,0,0,0,0.244462674
1400000US17031081201,17031081201,"Census Tract 812.01, Cook County, Illinois",4552,4216,3395,129,0,600,0,9,83,0,83,336,232,2,0,0,0,93,9,9,0,0.254173989
1400000US17031081202,17031081202,"Census Tract 812.02, Cook County, Illinois",3221,2930,2756,25,0,122,0,0,27,0,27,291,146,0,0,0,0,145,0,0,0,0.144365104
1400000US17031081300,17031081300,"Census Tract 813, Cook County, Illinois",5053,4828,3802,213,0,786,0,0,27,0,27,225,167,0,0,21,0,13,24,0,24,0.247575698
1400000US17031081401,17031081401,"Census Tract 814.01, Cook County, Illinois",2516,2468,1678,429,0,268,0,0,93,0,93,48,48,0,0,0,0,0,0,0,0,0.333068362
1400000US17031081402,17031081402,"Census Tract 814.02, Cook County, Illinois",4389,4180,3125,156,51,713,0,0,135,0,135,209,156,0,0,0,0,53,0,0,0,0.287992709
1400000US17031081403,17031081403,"Census Tract 814.03, Cook County, Illinois",7004,6480,4542,186,49,1542,0,0,161,0,161,524,304,0,0,29,0,191,0,0,0,0.351513421
1400000US17031081500,17031081500,"Census Tract 815, Cook County, Illinois",4400,4258,3183,92,0,795,0,14,174,0,174,142,142,0,0,0,0,0,0,0,0,0.276590909
1400000US17031081600,17031081600,"Census Tract 816, Cook County, Illinois",3177,3010,2317,38,0,491,0,23,141,0,141,167,167,0,0,0,0,0,0,0,0,0.270695625
1400000US17031081700,17031081700,"Census Tract 817, Cook County, Illinois",3607,2993,2217,136,0,606,0,0,34,0,34,614,149,0,51,0,0,414,0,0,0,0.385361797
1400000US17031081800,17031081800,"Census Tract 818, Cook County, Illinois",7488,7221,6074,179,49,630,0,38,251,80,171,267,244,0,0,0,0,23,0,0,0,0.18883547
1400000US17031081900,17031081900,"Census Tract 819, Cook County, Illinois",1152,1115,450,429,6,160,0,5,65,0,65,37,32,0,0,0,0,5,0,0,0,0.609375
1400000US17031090100,17031090100,"Census Tract 901, Cook County, Illinois",3262,2905,2838,0,0,55,0,0,12,0,12,357,273,0,0,0,0,84,0,0,0,0.129981606
1400000US17031090200,17031090200,"Census Tract 902, Cook County, Illinois",6406,5950,5620,117,0,132,0,0,81,0,81,456,456,0,0,0,0,0,0,0,0,0.122697471
1400000US17031090300,17031090300,"Census Tract 903, Cook County, Illinois",1325,1281,1243,0,0,31,0,0,7,0,7,44,26,0,0,0,0,6,12,12,0,0.061886792
1400000US17031100100,17031100100,"Census Tract 1001, Cook County, Illinois",5666,4911,4478,0,0,282,0,15,136,0,136,755,652,0,0,0,0,0,103,0,103,0.209671726
1400000US17031100200,17031100200,"Census Tract 1002, Cook County, Illinois",6605,5747,5455,208,0,10,0,19,55,0,55,858,610,0,51,0,20,177,0,0,0,0.174110522
1400000US17031100300,17031100300,"Census Tract 1003, Cook County, Illinois",6029,5250,4827,93,6,142,0,0,182,0,182,779,633,0,0,0,0,36,110,110,0,0.199369713
1400000US17031100400,17031100400,"Census Tract 1004, Cook County, Illinois",3027,2637,2516,5,0,54,0,0,62,0,62,390,345,0,0,0,0,45,0,0,0,0.168814007
1400000US17031100500,17031100500,"Census Tract 1005, Cook County, Illinois",5156,4851,4644,5,0,144,0,0,58,0,58,305,108,0,46,0,0,115,36,0,36,0.099301784
1400000US17031100600,17031100600,"Census Tract 1006, Cook County, Illinois",5254,4383,3973,23,0,310,0,0,77,0,77,871,593,30,0,0,0,248,0,0,0,0.243814237
1400000US17031100700,17031100700,"Census Tract 1007, Cook County, Illinois",4749,4199,3714,9,0,412,0,18,46,0,46,550,409,26,0,0,0,115,0,0,0,0.217940619
1400000US17031110100,17031110100,"Census Tract 1101, Cook County, Illinois",5923,4707,4100,120,0,401,0,0,86,13,73,1216,714,0,0,0,0,439,63,63,0,0.307783218
1400000US17031110200,17031110200,"Census Tract 1102, Cook County, Illinois",3017,2673,1991,74,51,345,0,4,208,11,197,344,271,0,0,0,0,39,34,34,0,0.34007292
1400000US17031110300,17031110300,"Census Tract 1103, Cook County, Illinois",5314,4329,3568,41,0,694,0,0,26,0,26,985,866,0,11,0,0,71,37,37,0,0.328566052
1400000US17031110400,17031110400,"Census Tract 1104, Cook County, Illinois",4439,3603,3223,23,0,313,0,0,44,0,44,836,524,0,0,0,0,203,109,66,43,0.273935571
1400000US17031110501,17031110501,"Census Tract 1105.01, Cook County, Illinois",4636,3606,3238,21,0,308,0,0,39,0,39,1030,806,0,0,0,0,101,123,123,0,0.301553063
1400000US17031110502,17031110502,"Census Tract 1105.02, Cook County, Illinois",3646,2683,2242,61,0,280,0,9,91,0,91,963,593,0,0,15,0,355,0,0,0,0.385079539
1400000US17031120100,17031120100,"Census Tract 1201, Cook County, Illinois",3993,3820,3545,1,0,200,0,0,74,0,74,173,133,0,0,0,0,40,0,0,0,0.112196344
1400000US17031120200,17031120200,"Census Tract 1202, Cook County, Illinois",4552,4050,3429,21,0,508,0,0,92,0,92,502,334,0,0,0,0,89,79,66,13,0.246704745
1400000US17031120300,17031120300,"Census Tract 1203, Cook County, Illinois",6179,5482,4235,9,0,1217,0,0,21,0,21,697,306,0,0,0,0,253,138,82,56,0.314614015
1400000US17031120400,17031120400,"Census Tract 1204, Cook County, Illinois",3754,2769,2066,0,0,622,0,0,81,0,81,985,273,0,0,0,0,655,57,57,0,0.449653703
1400000US17031130100,17031130100,"Census Tract 1301, Cook County, Illinois",5158,4511,3204,80,0,1170,0,0,57,0,57,647,391,0,15,52,0,189,0,0,0,0.378829003
1400000US17031130200,17031130200,"Census Tract 1302, Cook County, Illinois",1598,1290,1056,29,0,191,0,0,14,14,0,308,308,0,0,0,0,0,0,0,0,0.339173967
1400000US17031130300,17031130300,"Census Tract 1303, Cook County, Illinois",5260,4196,2227,161,0,1747,0,0,61,14,47,1064,461,50,0,28,0,294,231,203,28,0.57661597
1400000US17031140100,17031140100,"Census Tract 1401, Cook County, Illinois",4079,1764,983,291,0,430,0,0,60,27,33,2315,922,0,0,0,0,1350,43,25,18,0.759009561
1400000US17031140200,17031140200,"Census Tract 1402, Cook County, Illinois",5895,2936,1619,252,0,936,52,0,77,31,46,2959,1265,14,0,0,0,1583,97,97,0,0.725360475
1400000US17031140301,17031140301,"Census Tract 1403.01, Cook County, Illinois",2748,911,311,10,0,577,0,0,13,0,13,1837,768,13,0,0,0,1056,0,0,0,0.886826783
1400000US17031140302,17031140302,"Census Tract 1403.02, Cook County, Illinois",4472,2574,1145,370,0,947,0,0,112,0,112,1898,791,0,0,21,0,1042,44,20,24,0.743962433
1400000US17031140400,17031140400,"Census Tract 1404, Cook County, Illinois",7186,5222,3060,0,0,1909,0,34,219,20,199,1964,952,0,0,0,0,737,275,86,189,0.574172001
1400000US17031140500,17031140500,"Census Tract 1405, Cook County, Illinois",4121,2065,1372,67,0,585,0,0,41,0,41,2056,748,10,0,0,0,1034,264,238,26,0.667071099
1400000US17031140601,17031140601,"Census Tract 1406.01, Cook County, Illinois",2969,1089,416,28,0,602,0,4,39,0,39,1880,681,0,0,0,0,1179,20,0,20,0.859885483
1400000US17031140602,17031140602,"Census Tract 1406.02, Cook County, Illinois",5614,1701,1027,340,0,300,0,0,34,0,34,3913,1429,0,0,0,0,2301,183,152,31,0.817064482
1400000US17031140701,17031140701,"Census Tract 1407.01, Cook County, Illinois",2385,1176,831,71,0,217,0,0,57,0,57,1209,686,0,0,0,0,475,48,35,13,0.651572327
1400000US17031140702,17031140702,"Census Tract 1407.02, Cook County, Illinois",6252,2252,1313,389,0,462,0,0,88,0,88,4000,2502,50,0,0,0,1406,42,32,10,0.789987204
1400000US17031140800,17031140800,"Census Tract 1408, Cook County, Illinois",7209,4348,3344,199,0,422,0,91,292,15,277,2861,1621,0,0,0,0,1159,81,29,52,0.536135386
1400000US17031150200,17031150200,"Census Tract 1502, Cook County, Illinois",7821,5701,4828,264,0,487,0,0,122,0,122,2120,510,0,0,0,0,1493,117,117,0,0.382687636
1400000US17031150300,17031150300,"Census Tract 1503, Cook County, Illinois",7526,5100,4564,161,0,84,0,41,250,23,227,2426,831,9,0,0,0,1447,139,123,16,0.393568961
1400000US17031150401,17031150401,"Census Tract 1504.01, Cook County, Illinois",4805,3435,3266,16,0,142,0,0,11,0,11,1370,417,0,0,0,0,953,0,0,0,0.320291363
1400000US17031150402,17031150402,"Census Tract 1504.02, Cook County, Illinois",3695,1936,1860,0,0,59,0,9,8,0,8,1759,766,0,0,0,0,860,133,133,0,0.49661705
1400000US17031150501,17031150501,"Census Tract 1505.01, Cook County, Illinois",3743,2653,2468,3,0,148,0,0,34,0,34,1090,562,0,0,0,0,505,23,23,0,0.340635854
1400000US17031150502,17031150502,"Census Tract 1505.02, Cook County, Illinois",4290,2564,2191,21,0,333,0,0,19,0,19,1726,351,0,0,0,0,1292,83,52,31,0.489277389
1400000US17031150600,17031150600,"Census Tract 1506, Cook County, Illinois",3868,2275,2080,0,0,169,0,0,26,0,26,1593,587,0,0,0,0,971,35,35,0,0.462254395
1400000US17031150700,17031150700,"Census Tract 1507, Cook County, Illinois",4621,2626,2415,9,0,118,0,0,84,0,84,1995,1287,20,7,0,0,646,35,35,0,0.477385847
1400000US17031150800,17031150800,"Census Tract 1508, Cook County, Illinois",5451,2564,1968,25,0,509,0,19,43,0,43,2887,1314,0,0,0,0,1479,94,28,66,0.638965327
1400000US17031151001,17031151001,"Census Tract 1510.01, Cook County, Illinois",2538,829,710,46,0,49,0,0,24,0,24,1709,529,22,25,0,0,1120,13,0,13,0.720252167
1400000US17031151002,17031151002,"Census Tract 1510.02, Cook County, Illinois",4685,1652,1244,13,0,240,34,0,121,0,121,3033,1074,0,9,94,0,1838,18,18,0,0.734471718
1400000US17031151100,17031151100,"Census Tract 1511, Cook County, Illinois",5391,2673,2303,27,8,321,0,0,14,0,14,2718,1118,9,0,0,36,1395,160,92,68,0.572806529
1400000US17031151200,17031151200,"Census Tract 1512, Cook County, Illinois",3680,2404,2136,123,0,108,0,0,37,0,37,1276,742,0,0,0,0,504,30,0,30,0.419565217
1400000US17031160100,17031160100,"Census Tract 1601, Cook County, Illinois",2626,1873,1351,5,37,388,0,0,92,0,92,753,645,0,0,0,0,100,8,8,0,0.485529322
1400000US17031160200,17031160200,"Census Tract 1602, Cook County, Illinois",3822,2717,2044,114,69,328,0,10,152,0,152,1105,523,0,0,0,0,582,0,0,0,0.465201465
1400000US17031160300,17031160300,"Census Tract 1603, Cook County, Illinois",3877,2943,1881,657,0,304,0,51,50,11,39,934,548,10,10,11,0,355,0,0,0,0.514831055
1400000US17031160400,17031160400,"Census Tract 1604, Cook County, Illinois",5090,2828,2370,160,0,200,0,0,98,0,98,2262,1222,20,0,0,0,992,28,28,0,0.534381139
1400000US17031160501,17031160501,"Census Tract 1605.01, Cook County, Illinois",4498,1330,762,174,0,332,0,0,62,0,62,3168,2199,0,0,0,0,969,0,0,0,0.830591374
1400000US17031160502,17031160502,"Census Tract 1605.02, Cook County, Illinois",4568,1525,1138,30,0,333,0,0,24,0,24,3043,1748,9,0,23,0,1231,32,0,32,0.750875657
1400000US17031160601,17031160601,"Census Tract 1606.01, Cook County, Illinois",3999,1612,1444,17,0,115,0,0,36,0,36,2387,1761,0,0,8,0,611,7,0,7,0.638909727
1400000US17031160602,17031160602,"Census Tract 1606.02, Cook County, Illinois",3983,2064,1534,76,0,314,34,17,89,0,89,1919,1253,0,0,0,0,501,165,165,0,0.614863168
1400000US17031160700,17031160700,"Census Tract 1607, Cook County, Illinois",6008,3526,2436,180,8,744,0,24,134,0,134,2482,1706,114,0,48,0,565,49,17,32,0.594540613
1400000US17031160800,17031160800,"Census Tract 1608, Cook County, Illinois",5388,2309,1645,52,0,472,0,6,134,81,53,3079,2567,0,0,0,0,447,65,35,30,0.694691908
1400000US17031160900,17031160900,"Census Tract 1609, Cook County, Illinois",2272,1687,1381,1,0,270,0,11,24,0,24,585,541,13,1,0,0,24,6,6,0,0.392165493
1400000US17031161000,17031161000,"Census Tract 1610, Cook County, Illinois",1726,1145,1091,8,1,39,0,0,6,0,6,581,458,6,0,0,0,105,12,12,0,0.367902665
1400000US17031161100,17031161100,"Census Tract 1611, Cook County, Illinois",2026,1635,1373,39,0,125,0,7,91,0,91,391,363,10,0,0,0,11,7,7,0,0.32230997
1400000US17031161200,17031161200,"Census Tract 1612, Cook County, Illinois",2664,1297,814,19,0,284,0,0,180,79,101,1367,1192,0,0,13,0,156,6,6,0,0.694444444
1400000US17031161300,17031161300,"Census Tract 1613, Cook County, Illinois",3943,1441,1228,114,0,39,0,0,60,0,60,2502,2281,0,0,0,0,195,26,17,9,0.688562009
1400000US17031170100,17031170100,"Census Tract 1701, Cook County, Illinois",1871,1649,1480,65,0,104,0,0,0,0,0,222,205,0,0,0,0,17,0,0,0,0.208979156
1400000US17031170200,17031170200,"Census Tract 1702, Cook County, Illinois",4366,2705,2492,1,77,103,0,0,32,0,32,1661,1020,0,0,0,0,641,0,0,0,0.429225836
1400000US17031170300,17031170300,"Census Tract 1703, Cook County, Illinois",4918,3646,3292,3,0,293,0,0,58,0,58,1272,706,0,9,0,0,541,16,6,10,0.330622204
1400000US17031170400,17031170400,"Census Tract 1704, Cook County, Illinois",3720,2960,2778,17,7,138,0,10,10,0,10,760,730,0,0,0,0,25,5,5,0,0.253225806
1400000US17031170500,17031170500,"Census Tract 1705, Cook County, Illinois",4888,3905,3622,128,0,101,0,0,54,0,54,983,854,20,0,8,0,90,11,11,0,0.259001637
1400000US17031170600,17031170600,"Census Tract 1706, Cook County, Illinois",2774,2259,1935,66,0,237,0,0,21,0,21,515,331,0,4,0,0,143,37,24,13,0.302451334
1400000US17031170700,17031170700,"Census Tract 1707, Cook County, Illinois",2831,2268,2098,8,0,162,0,0,0,0,0,563,348,0,0,42,0,123,50,0,50,0.25891911
1400000US17031170800,17031170800,"Census Tract 1708, Cook County, Illinois",3750,2921,2799,0,0,75,0,0,47,0,47,829,681,11,0,7,6,99,25,13,12,0.2536
1400000US17031170900,17031170900,"Census Tract 1709, Cook County, Illinois",1729,1243,1227,9,0,7,0,0,0,0,0,486,232,0,0,0,0,254,0,0,0,0.290341238
1400000US17031171000,17031171000,"Census Tract 1710, Cook County, Illinois",7949,5597,4964,341,0,237,29,0,26,0,26,2352,1728,0,0,0,0,599,25,13,12,0.375518933
1400000US17031171100,17031171100,"Census Tract 1711, Cook County, Illinois",4257,2645,2373,56,0,126,0,0,90,0,90,1612,1248,0,0,0,0,303,61,61,0,0.442565187
1400000US17031180100,17031180100,"Census Tract 1801, Cook County, Illinois",5918,2911,2454,60,0,376,0,0,21,0,21,3007,1833,92,0,0,15,1048,19,0,19,0.585332883
1400000US17031190100,17031190100,"Census Tract 1901, Cook County, Illinois",2720,760,395,82,0,269,0,0,14,0,14,1960,791,0,0,0,0,1070,99,99,0,0.854779412
1400000US17031190200,17031190200,"Census Tract 1902, Cook County, Illinois",5694,1198,936,83,0,110,0,0,69,44,25,4496,1126,17,0,0,0,2976,377,346,31,0.835616438
1400000US17031190300,17031190300,"Census Tract 1903, Cook County, Illinois",5445,1869,1729,35,0,67,0,15,23,0,23,3576,1461,0,23,0,0,2055,37,37,0,0.682460973
1400000US17031190401,17031190401,"Census Tract 1904.01, Cook County, Illinois",4183,1651,1600,0,0,51,0,0,0,0,0,2532,1100,0,0,0,0,1396,36,36,0,0.617499402
1400000US17031190402,17031190402,"Census Tract 1904.02, Cook County, Illinois",4642,1453,1105,120,0,201,0,0,27,0,27,3189,1475,43,29,0,0,1483,159,52,107,0.761956053
1400000US17031190601,17031190601,"Census Tract 1906.01, Cook County, Illinois",4777,778,512,204,0,62,0,0,0,0,0,3999,1376,0,0,0,0,2623,0,0,0,0.892819761
1400000US17031190602,17031190602,"Census Tract 1906.02, Cook County, Illinois",5265,1153,670,254,0,111,0,72,46,0,46,4112,1514,10,8,16,0,2539,25,25,0,0.872744539
1400000US17031190701,17031190701,"Census Tract 1907.01, Cook County, Illinois",3072,618,490,57,0,15,0,10,46,0,46,2454,688,23,0,0,0,1677,66,49,17,0.840494792
1400000US17031190702,17031190702,"Census Tract 1907.02, Cook County, Illinois",5090,1077,756,263,8,35,0,0,15,6,9,4013,1395,54,0,0,0,2564,0,0,0,0.851473477
1400000US17031190800,17031190800,"Census Tract 1908, Cook County, Illinois",6881,1003,722,34,0,87,0,33,127,0,127,5878,1737,39,34,34,17,3819,198,141,57,0.89507339
1400000US17031190900,17031190900,"Census Tract 1909, Cook County, Illinois",1864,297,216,58,0,0,0,17,6,0,6,1567,412,21,0,10,0,1124,0,0,0,0.884120172
1400000US17031191000,17031191000,"Census Tract 1910, Cook County, Illinois",2901,215,107,108,0,0,0,0,0,0,0,2686,1145,0,0,0,0,1414,127,127,0,0.963116167
1400000US17031191100,17031191100,"Census Tract 1911, Cook County, Illinois",7936,680,343,240,0,26,0,0,71,0,71,7256,2099,21,23,0,0,4937,176,99,77,0.956779234
1400000US17031191200,17031191200,"Census Tract 1912, Cook County, Illinois",3975,401,301,100,0,0,0,0,0,0,0,3574,823,7,8,0,0,2725,11,5,6,0.92427673
1400000US17031191301,17031191301,"Census Tract 1913.01, Cook County, Illinois",5941,954,87,698,0,169,0,0,0,0,0,4987,1636,0,0,0,0,3299,52,52,0,0.985356001
1400000US17031191302,17031191302,"Census Tract 1913.02, Cook County, Illinois",5088,470,183,265,0,0,0,0,22,0,22,4618,2290,132,0,0,0,2100,96,96,0,0.964033019
1400000US17031200100,17031200100,"Census Tract 2001, Cook County, Illinois",4603,1019,756,56,0,170,0,0,37,0,37,3584,1387,15,0,0,37,2096,49,19,30,0.835759287
1400000US17031200200,17031200200,"Census Tract 2002, Cook County, Illinois",4968,585,406,74,21,0,0,58,26,0,26,4383,1040,26,0,0,0,3290,27,19,8,0.918276973
1400000US17031200300,17031200300,"Census Tract 2003, Cook County, Illinois",2401,180,145,0,0,26,0,9,0,0,0,2221,723,16,0,0,5,1409,68,63,5,0.939608496
1400000US17031200401,17031200401,"Census Tract 2004.01, Cook County, Illinois",3814,202,142,60,0,0,0,0,0,0,0,3612,1602,54,0,0,0,1899,57,4,53,0.962768747
1400000US17031200402,17031200402,"Census Tract 2004.02, Cook County, Illinois",4033,269,124,31,0,8,0,52,54,0,54,3764,908,50,10,0,0,2716,80,55,25,0.969253657
1400000US17031210100,17031210100,"Census Tract 2101, Cook County, Illinois",3447,2189,1791,54,12,152,0,0,180,0,180,1258,1025,0,30,0,0,203,0,0,0,0.480417755
1400000US17031210400,17031210400,"Census Tract 2104, Cook County, Illinois",3128,961,695,61,0,181,0,6,18,12,6,2167,2006,0,11,0,0,119,31,3,28,0.777813299
1400000US17031210501,17031210501,"Census Tract 2105.01, Cook County, Illinois",4569,1532,1229,169,22,46,0,0,66,0,66,3037,2565,0,117,0,0,304,51,11,40,0.731013351
1400000US17031210502,17031210502,"Census Tract 2105.02, Cook County, Illinois",4909,1701,1508,47,20,5,0,0,121,0,121,3208,2948,19,0,0,0,241,0,0,0,0.692809126
1400000US17031210601,17031210601,"Census Tract 2106.01, Cook County, Illinois",3066,899,595,62,0,212,0,0,30,0,30,2167,1692,0,0,0,0,463,12,6,6,0.805936073
1400000US17031210602,17031210602,"Census Tract 2106.02, Cook County, Illinois",4126,1314,1130,98,17,26,0,0,43,0,43,2812,2488,102,0,0,0,177,45,45,0,0.726127
1400000US17031210700,17031210700,"Census Tract 2107, Cook County, Illinois",3978,1790,1606,21,0,146,0,0,17,0,17,2188,1964,0,10,15,0,151,48,19,29,0.596279537
1400000US17031210800,17031210800,"Census Tract 2108, Cook County, Illinois",1028,480,459,4,0,13,0,0,4,0,4,548,417,4,0,0,0,127,0,0,0,0.553501946
1400000US17031210900,17031210900,"Census Tract 2109, Cook County, Illinois",3223,1350,1037,167,0,134,0,0,12,0,12,1873,1464,33,0,0,0,376,0,0,0,0.678250078
1400000US17031220300,17031220300,"Census Tract 2203, Cook County, Illinois",2409,1578,1424,65,3,44,0,0,42,3,39,831,557,15,0,0,0,189,70,18,52,0.408883354
1400000US17031220400,17031220400,"Census Tract 2204, Cook County, Illinois",2565,1595,1504,0,8,64,0,0,19,0,19,970,697,0,0,9,0,264,0,0,0,0.413645224
1400000US17031220500,17031220500,"Census Tract 2205, Cook County, Illinois",2682,1948,1685,142,0,71,0,10,40,0,40,734,646,32,0,0,0,49,7,0,7,0.371737509
1400000US17031220601,17031220601,"Census Tract 2206.01, Cook County, Illinois",1596,866,729,112,0,5,14,0,6,0,6,730,626,43,0,0,0,40,21,3,18,0.543233083
1400000US17031220602,17031220602,"Census Tract 2206.02, Cook County, Illinois",4690,3044,2443,237,55,208,0,0,101,0,101,1646,1352,68,0,45,0,155,26,0,26,0.479104478
1400000US17031220701,17031220701,"Census Tract 2207.01, Cook County, Illinois",3459,1243,815,348,0,72,0,0,8,0,8,2216,2069,0,6,0,0,134,7,7,0,0.76438277
1400000US17031220702,17031220702,"Census Tract 2207.02, Cook County, Illinois",4426,1109,709,218,0,68,0,0,114,0,114,3317,2554,91,0,0,0,672,0,0,0,0.839810212
1400000US17031220901,17031220901,"Census Tract 2209.01, Cook County, Illinois",3297,799,542,257,0,0,0,0,0,0,0,2498,1683,0,51,0,0,617,147,64,83,0.835608129
1400000US17031220902,17031220902,"Census Tract 2209.02, Cook County, Illinois",3325,688,614,57,0,3,0,0,14,0,14,2637,2357,11,5,0,0,219,45,7,38,0.815338346
1400000US17031221000,17031221000,"Census Tract 2210, Cook County, Illinois",3254,773,507,205,27,7,0,6,21,0,21,2481,2102,19,0,0,0,327,33,0,33,0.844191764
1400000US17031221100,17031221100,"Census Tract 2211, Cook County, Illinois",4810,2782,1766,745,0,80,0,30,161,0,161,2028,1593,34,8,0,0,328,65,65,0,0.632848233
1400000US17031221200,17031221200,"Census Tract 2212, Cook County, Illinois",3065,1749,1546,94,0,58,0,0,51,0,51,1316,918,17,0,59,0,265,57,0,57,0.495595432
1400000US17031221300,17031221300,"Census Tract 2213, Cook County, Illinois",2762,1570,1306,153,33,45,0,8,25,0,25,1192,842,0,22,0,0,253,75,45,30,0.527154236
1400000US17031221400,17031221400,"Census Tract 2214, Cook County, Illinois",2799,1349,1146,122,0,73,0,0,8,0,8,1450,1377,0,0,0,0,73,0,0,0,0.59056806
1400000US17031221500,17031221500,"Census Tract 2215, Cook County, Illinois",2574,1317,1141,99,0,46,0,0,31,0,31,1257,1129,0,7,0,0,104,17,17,0,0.556721057
1400000US17031221600,17031221600,"Census Tract 2216, Cook County, Illinois",3118,2393,2171,25,0,97,0,8,92,23,69,725,565,0,0,0,0,151,9,0,9,0.303720334
1400000US17031222200,17031222200,"Census Tract 2222, Cook County, Illinois",1964,1830,1619,62,0,99,0,0,50,0,50,134,77,0,0,38,0,19,0,0,0,0.175661914
1400000US17031222500,17031222500,"Census Tract 2225, Cook County, Illinois",1424,475,370,81,0,0,0,0,24,0,24,949,837,7,0,0,0,105,0,0,0,0.740168539
1400000US17031222600,17031222600,"Census Tract 2226, Cook County, Illinois",1554,872,658,116,0,90,0,4,4,0,4,682,538,0,0,0,0,98,46,0,46,0.576576577
1400000US17031222700,17031222700,"Census Tract 2227, Cook County, Illinois",2660,909,662,223,13,8,0,0,3,0,3,1751,1568,25,0,0,0,139,19,16,3,0.75112782
1400000US17031222800,17031222800,"Census Tract 2228, Cook County, Illinois",1014,209,62,144,0,0,0,0,3,0,3,805,698,36,0,0,0,71,0,0,0,0.938856016
1400000US17031222900,17031222900,"Census Tract 2229, Cook County, Illinois",878,242,158,84,0,0,0,0,0,0,0,636,479,39,0,0,0,113,5,5,0,0.820045558
1400000US17031230100,17031230100,"Census Tract 2301, Cook County, Illinois",1646,832,406,390,0,21,0,0,15,4,11,814,159,6,0,0,0,628,21,21,0,0.753341434
1400000US17031230200,17031230200,"Census Tract 2302, Cook County, Illinois",1972,500,205,268,0,6,0,6,15,0,15,1472,559,16,0,0,0,735,162,75,87,0.896044625
1400000US17031230300,17031230300,"Census Tract 2303, Cook County, Illinois",1170,139,44,38,45,12,0,0,0,0,0,1031,375,0,0,0,0,656,0,0,0,0.962393162
1400000US17031230400,17031230400,"Census Tract 2304, Cook County, Illinois",2666,217,99,100,0,9,0,5,4,0,4,2449,989,0,7,6,0,1397,50,50,0,0.962865716
1400000US17031230500,17031230500,"Census Tract 2305, Cook County, Illinois",3710,506,107,272,0,104,0,0,23,0,23,3204,1029,24,28,0,0,2088,35,35,0,0.97115903
1400000US17031230600,17031230600,"Census Tract 2306, Cook County, Illinois",6933,3216,317,2720,0,0,0,27,152,0,152,3717,908,59,84,0,0,2529,137,104,33,0.954276648
1400000US17031230700,17031230700,"Census Tract 2307, Cook County, Illinois",5177,713,146,541,0,26,0,0,0,0,0,4464,1251,64,25,0,0,2955,169,63,106,0.971798339
1400000US17031230800,17031230800,"Census Tract 2308, Cook County, Illinois",1195,223,86,69,0,0,0,64,4,0,4,972,316,3,12,0,0,641,0,0,0,0.928033473
1400000US17031230900,17031230900,"Census Tract 2309, Cook County, Illinois",5155,2311,638,1491,0,92,0,58,32,0,32,2844,563,93,0,0,0,2145,43,8,35,0.876236663
1400000US17031231100,17031231100,"Census Tract 2311, Cook County, Illinois",1227,848,85,752,0,0,0,0,11,0,11,379,172,4,0,0,0,203,0,0,0,0.930725346
1400000US17031231200,17031231200,"Census Tract 2312, Cook County, Illinois",5102,3367,97,3122,0,0,0,125,23,0,23,1735,292,95,0,0,0,1332,16,16,0,0.980987848
1400000US17031231500,17031231500,"Census Tract 2315, Cook County, Illinois",6965,6553,184,6350,0,0,0,0,19,0,19,412,5,16,0,0,0,356,35,35,0,0.973582197
1400000US17031240200,17031240200,"Census Tract 2402, Cook County, Illinois",1469,1204,1117,16,0,43,0,0,28,0,28,265,155,12,0,5,0,93,0,0,0,0.239618788
1400000US17031240300,17031240300,"Census Tract 2403, Cook County, Illinois",1402,1335,1214,0,0,93,0,0,28,5,23,67,54,0,0,0,0,7,6,6,0,0.134094151
1400000US17031240500,17031240500,"Census Tract 2405, Cook County, Illinois",2154,1896,1666,24,0,122,0,0,84,0,84,258,188,0,0,0,0,70,0,0,0,0.226555246
1400000US17031240600,17031240600,"Census Tract 2406, Cook County, Illinois",1340,936,849,26,0,14,0,0,47,0,47,404,293,10,0,0,0,101,0,0,0,0.36641791
1400000US17031240700,17031240700,"Census Tract 2407, Cook County, Illinois",1427,829,546,142,0,83,0,0,58,0,58,598,492,19,0,0,0,87,0,0,0,0.617379117
1400000US17031240800,17031240800,"Census Tract 2408, Cook County, Illinois",1816,564,405,107,0,4,0,0,48,0,48,1252,988,26,0,0,0,226,12,5,7,0.776982379
1400000US17031240900,17031240900,"Census Tract 2409, Cook County, Illinois",1236,539,281,124,0,86,0,33,15,0,15,697,432,0,14,0,0,159,92,30,62,0.772653722
1400000US17031241000,17031241000,"Census Tract 2410, Cook County, Illinois",2036,1017,433,575,0,0,0,0,9,0,9,1019,665,69,0,0,0,268,17,14,3,0.787328094
1400000US17031241100,17031241100,"Census Tract 2411, Cook County, Illinois",4015,2209,1634,273,0,139,0,31,132,0,132,1806,796,47,0,0,0,844,119,119,0,0.593026152
1400000US17031241200,17031241200,"Census Tract 2412, Cook County, Illinois",1952,1513,1173,134,0,180,0,0,26,0,26,439,289,0,0,0,0,144,6,6,0,0.399077869
1400000US17031241300,17031241300,"Census Tract 2413, Cook County, Illinois",1878,1498,1212,243,0,33,0,0,10,0,10,380,227,0,0,0,0,153,0,0,0,0.354632588
1400000US17031241400,17031241400,"Census Tract 2414, Cook County, Illinois",5238,4730,3413,706,0,364,0,26,221,0,221,508,267,0,0,0,0,93,148,135,13,0.348415426
1400000US17031241500,17031241500,"Census Tract 2415, Cook County, Illinois",2881,2320,2058,41,0,139,0,0,82,0,82,561,370,39,0,0,0,152,0,0,0,0.2856647
1400000US17031241600,17031241600,"Census Tract 2416, Cook County, Illinois",3438,2719,2223,132,0,309,0,10,45,0,45,719,452,0,0,9,0,196,62,40,22,0.353403141
1400000US17031242000,17031242000,"Census Tract 2420, Cook County, Illinois",4786,3089,2166,598,0,91,0,43,191,1,190,1697,854,26,0,0,0,774,43,43,0,0.547430004
1400000US17031242100,17031242100,"Census Tract 2421, Cook County, Illinois",3311,2679,2435,95,11,75,0,11,52,0,52,632,255,8,0,0,0,313,56,23,33,0.264572637
1400000US17031242200,17031242200,"Census Tract 2422, Cook County, Illinois",3875,3006,2585,146,29,96,0,82,68,0,68,869,726,65,0,15,0,63,0,0,0,0.332903226
1400000US17031242300,17031242300,"Census Tract 2423, Cook County, Illinois",3003,2556,2355,94,0,62,0,0,45,0,45,447,278,14,26,0,0,129,0,0,0,0.215784216
1400000US17031242400,17031242400,"Census Tract 2424, Cook County, Illinois",2926,2682,2475,56,0,120,0,0,31,0,31,244,116,0,0,0,0,128,0,0,0,0.154135338
1400000US17031242500,17031242500,"Census Tract 2425, Cook County, Illinois",3928,2307,1958,130,0,96,0,38,85,52,33,1621,1004,0,0,0,0,526,91,46,45,0.501527495
1400000US17031242600,17031242600,"Census Tract 2426, Cook County, Illinois",5999,3984,2724,811,81,137,0,0,231,0,231,2015,872,65,0,0,0,1057,21,21,0,0.545924321
1400000US17031242700,17031242700,"Census Tract 2427, Cook County, Illinois",1689,1000,499,434,0,7,0,0,60,14,46,689,318,37,0,0,0,297,37,12,25,0.704558911
1400000US17031242800,17031242800,"Census Tract 2428, Cook County, Illinois",1515,1257,1204,5,0,48,0,0,0,0,0,258,125,0,0,0,0,133,0,0,0,0.205280528
1400000US17031242900,17031242900,"Census Tract 2429, Cook County, Illinois",1818,1181,1006,102,0,39,0,0,34,0,34,637,272,0,0,0,0,293,72,68,4,0.446644664
1400000US17031243000,17031243000,"Census Tract 2430, Cook County, Illinois",2398,1103,1052,0,0,51,0,0,0,0,0,1295,1038,0,0,0,0,257,0,0,0,0.561301084
1400000US17031243100,17031243100,"Census Tract 2431, Cook County, Illinois",2594,1331,1179,96,0,34,0,17,5,0,5,1263,637,106,19,0,0,501,0,0,0,0.545489591
1400000US17031243200,17031243200,"Census Tract 2432, Cook County, Illinois",2190,1401,1309,19,0,38,0,0,35,0,35,789,473,5,0,0,0,276,35,35,0,0.402283105
1400000US17031243300,17031243300,"Census Tract 2433, Cook County, Illinois",2353,1663,1434,70,28,119,0,0,12,0,12,690,510,9,0,0,0,171,0,0,0,0.390565236
1400000US17031243400,17031243400,"Census Tract 2434, Cook County, Illinois",2955,1812,1419,164,0,180,0,0,49,8,41,1143,644,21,16,0,0,455,7,7,0,0.519796954
1400000US17031243500,17031243500,"Census Tract 2435, Cook County, Illinois",3198,2959,2205,392,0,264,0,0,98,0,98,239,221,0,0,0,0,18,0,0,0,0.310506567
1400000US17031250200,17031250200,"Census Tract 2502, Cook County, Illinois",2968,1733,29,1671,0,24,0,0,9,0,9,1235,470,181,0,0,0,584,0,0,0,0.990229111
1400000US17031250300,17031250300,"Census Tract 2503, Cook County, Illinois",4775,3686,68,3460,0,72,22,0,64,0,64,1089,170,0,0,0,0,919,0,0,0,0.985759162
1400000US17031250400,17031250400,"Census Tract 2504, Cook County, Illinois",5963,4796,64,4709,0,9,0,14,0,0,0,1167,151,120,0,0,0,791,105,105,0,0.989267147
1400000US17031250500,17031250500,"Census Tract 2505, Cook County, Illinois",7663,5780,2729,2546,0,214,0,93,198,0,198,1883,1263,73,0,0,0,533,14,14,0,0.643873157
1400000US17031250600,17031250600,"Census Tract 2506, Cook County, Illinois",4450,4124,26,4076,0,0,0,0,22,0,22,326,70,0,0,0,0,256,0,0,0,0.994157303
1400000US17031250700,17031250700,"Census Tract 2507, Cook County, Illinois",5813,5497,0,5477,0,20,0,0,0,0,0,316,25,133,0,0,0,158,0,0,0,1
1400000US17031250800,17031250800,"Census Tract 2508, Cook County, Illinois",2438,1960,33,1873,0,41,0,0,13,0,13,478,119,0,0,0,0,348,11,6,5,0.986464315
1400000US17031251000,17031251000,"Census Tract 2510, Cook County, Illinois",1284,1127,8,1119,0,0,0,0,0,0,0,157,141,0,0,0,0,16,0,0,0,0.99376947
1400000US17031251100,17031251100,"Census Tract 2511, Cook County, Illinois",4346,3811,37,3755,0,19,0,0,0,0,0,535,108,9,0,0,0,350,68,17,51,0.991486424
1400000US17031251200,17031251200,"Census Tract 2512, Cook County, Illinois",4375,4332,139,4078,99,0,0,0,16,0,16,43,0,0,0,0,0,43,0,0,0,0.968228571
1400000US17031251300,17031251300,"Census Tract 2513, Cook County, Illinois",4735,4436,41,4386,0,0,0,0,9,0,9,299,133,0,0,0,0,156,10,10,0,0.991341077
1400000US17031251400,17031251400,"Census Tract 2514, Cook County, Illinois",4347,4173,177,3965,0,14,0,9,8,0,8,174,7,150,8,0,0,9,0,0,0,0.959282264
1400000US17031251500,17031251500,"Census Tract 2515, Cook County, Illinois",4084,3827,71,3756,0,0,0,0,0,0,0,257,80,65,0,0,0,78,34,34,0,0.982615083
1400000US17031251600,17031251600,"Census Tract 2516, Cook County, Illinois",3689,3495,73,3333,0,0,0,0,89,0,89,194,12,19,15,0,0,148,0,0,0,0.980211439
1400000US17031251700,17031251700,"Census Tract 2517, Cook County, Illinois",1805,1469,24,1433,0,12,0,0,0,0,0,336,54,0,24,0,36,222,0,0,0,0.986703601
1400000US17031251800,17031251800,"Census Tract 2518, Cook County, Illinois",5069,5069,37,5009,23,0,0,0,0,0,0,0,0,0,0,0,0,0,0,0,0,0.99270073
1400000US17031251900,17031251900,"Census Tract 2519, Cook County, Illinois",5999,5790,81,5676,33,0,0,0,0,0,0,209,0,59,0,0,0,150,0,0,0,0.98649775
1400000US17031252000,17031252000,"Census Tract 2520, Cook County, Illinois",6368,6149,86,6058,0,0,0,0,5,0,5,219,160,59,0,0,0,0,0,0,0,0.986494975
1400000US17031252101,17031252101,"Census Tract 2521.01, Cook County, Illinois",1787,1719,19,1654,0,0,0,0,46,0,46,68,0,0,0,0,0,68,0,0,0,0.989367655
1400000US17031252102,17031252102,"Census Tract 2521.02, Cook County, Illinois",5888,5888,0,5888,0,0,0,0,0,0,0,0,0,0,0,0,0,0,0,0,0,1
1400000US17031252201,17031252201,"Census Tract 2522.01, Cook County, Illinois",3007,2986,98,2885,0,0,0,0,3,0,3,21,14,0,0,0,0,0,7,0,7,0.967409378
1400000US17031252202,17031252202,"Census Tract 2522.02, Cook County, Illinois",4871,4847,68,4779,0,0,0,0,0,0,0,24,0,0,0,0,0,0,24,24,0,0.986039828
1400000US17031260100,17031260100,"Census Tract 2601, Cook County, Illinois",1047,1040,79,953,0,0,0,0,8,0,8,7,7,0,0,0,0,0,0,0,0,0.924546323
1400000US17031260200,17031260200,"Census Tract 2602, Cook County, Illinois",1266,1230,5,1225,0,0,0,0,0,0,0,36,23,13,0,0,0,0,0,0,0,0.996050553
1400000US17031260300,17031260300,"Census Tract 2603, Cook County, Illinois",1483,1436,27,1391,0,0,0,0,18,0,18,47,0,0,0,0,0,47,0,0,0,0.981793661
1400000US17031260400,17031260400,"Census Tract 2604, Cook County, Illinois",1567,1566,14,1551,0,1,0,0,0,0,0,1,0,0,0,0,0,1,0,0,0,0.991065731
1400000US17031260500,17031260500,"Census Tract 2605, Cook County, Illinois",1837,1777,7,1769,0,1,0,0,0,0,0,60,0,0,0,0,0,60,0,0,0,0.996189439
1400000US17031260600,17031260600,"Census Tract 2606, Cook County, Illinois",2592,2578,71,2482,0,25,0,0,0,0,0,14,14,0,0,0,0,0,0,0,0,0.972608025
1400000US17031260700,17031260700,"Census Tract 2607, Cook County, Illinois",2147,1967,25,1903,7,17,0,0,15,0,15,180,0,14,0,0,0,166,0,0,0,0.988355845
1400000US17031260800,17031260800,"Census Tract 2608, Cook County, Illinois",2494,2494,16,2473,0,5,0,0,0,0,0,0,0,0,0,0,0,0,0,0,0,0.993584603
1400000US17031260900,17031260900,"Census Tract 2609, Cook County, Illinois",1858,1814,45,1752,17,0,0,0,0,0,0,44,44,0,0,0,0,0,0,0,0,0.975780409
1400000US17031261000,17031261000,"Census Tract 2610, Cook County, Illinois",2594,2584,0,2584,0,0,0,0,0,0,0,10,0,0,0,0,0,10,0,0,0,1
1400000US17031270500,17031270500,"Census Tract 2705, Cook County, Illinois",1929,1886,52,1775,16,0,0,0,43,0,43,43,36,7,0,0,0,0,0,0,0,0.973043027
1400000US17031271200,17031271200,"Census Tract 2712, Cook County, Illinois",1104,1081,10,1071,0,0,0,0,0,0,0,23,0,0,0,0,0,11,12,12,0,0.990942029
1400000US17031271300,17031271300,"Census Tract 2713, Cook County, Illinois",1169,1166,6,1156,0,0,0,4,0,0,0,3,3,0,0,0,0,0,0,0,0,0.994867408
1400000US17031271400,17031271400,"Census Tract 2714, Cook County, Illinois",1151,1150,39,1111,0,0,0,0,0,0,0,1,1,0,0,0,0,0,0,0,0,0.966116421
1400000US17031271500,17031271500,"Census Tract 2715, Cook County, Illinois",1286,1268,20,1239,0,0,0,0,9,0,9,18,0,0,0,0,0,0,18,10,8,0.9844479
1400000US17031271800,17031271800,"Census Tract 2718, Cook County, Illinois",1230,1230,11,1219,0,0,0,0,0,0,0,0,0,0,0,0,0,0,0,0,0,0.991056911
1400000US17031280100,17031280100,"Census Tract 2801, Cook County, Illinois",6524,6117,5012,257,0,761,0,53,34,0,34,407,371,0,20,0,0,16,0,0,0,0.231759657
1400000US17031280400,17031280400,"Census Tract 2804, Cook County, Illinois",1366,1358,57,1267,0,26,0,0,8,0,8,8,0,4,0,0,0,4,0,0,0,0.958272328
1400000US17031280800,17031280800,"Census Tract 2808, Cook County, Illinois",850,822,83,724,0,0,0,0,15,0,15,28,17,0,0,0,0,11,0,0,0,0.902352941
1400000US17031280900,17031280900,"Census Tract 2809, Cook County, Illinois",790,738,56,668,0,4,0,0,10,4,6,52,7,9,0,0,0,25,11,11,0,0.929113924
1400000US17031281900,17031281900,"Census Tract 2819, Cook County, Illinois",4820,4398,2088,301,0,1897,0,0,112,0,112,422,317,16,0,40,0,0,49,0,49,0.566804979
1400000US17031282700,17031282700,"Census Tract 2827, Cook County, Illinois",2402,1574,379,1047,0,138,0,0,10,0,10,828,549,112,0,15,0,123,29,7,22,0.842214821
1400000US17031282800,17031282800,"Census Tract 2828, Cook County, Illinois",1565,1205,632,306,0,230,0,0,37,0,37,360,187,8,0,10,0,147,8,0,8,0.596166134
1400000US17031283100,17031283100,"Census Tract 2831, Cook County, Illinois",2758,2672,717,1241,0,634,11,8,61,0,61,86,75,0,0,0,0,11,0,0,0,0.740029007
1400000US17031283200,17031283200,"Census Tract 2832, Cook County, Illinois",1481,1407,564,576,0,245,0,0,22,0,22,74,19,0,15,0,0,17,23,23,0,0.619176232
1400000US17031283800,17031283800,"Census Tract 2838, Cook County, Illinois",3367,3061,893,1575,0,502,0,22,69,0,69,306,146,75,0,0,0,64,21,10,11,0.734778735
1400000US17031290900,17031290900,"Census Tract 2909, Cook County, Illinois",3449,3431,33,3354,0,0,0,0,44,0,44,18,0,18,0,0,0,0,0,0,0,0.990432009
1400000US17031291200,17031291200,"Census Tract 2912, Cook County, Illinois",2368,2368,29,2337,0,0,0,0,2,0,2,0,0,0,0,0,0,0,0,0,0,0.987753378
1400000US17031291600,17031291600,"Census Tract 2916, Cook County, Illinois",804,242,72,167,0,3,0,0,0,0,0,562,221,0,0,0,0,341,0,0,0,0.910447761
1400000US17031292200,17031292200,"Census Tract 2922, Cook County, Illinois",2866,2783,65,2687,8,0,0,0,23,0,23,83,83,0,0,0,0,0,0,0,0,0.977320307
1400000US17031292400,17031292400,"Census Tract 2924, Cook County, Illinois",2124,2095,131,1958,0,0,0,0,6,0,6,29,29,0,0,0,0,0,0,0,0,0.938323917
1400000US17031292500,17031292500,"Census Tract 2925, Cook County, Illinois",4276,4147,54,4093,0,0,0,0,0,0,0,129,12,99,0,0,0,18,0,0,0,0.987371375
1400000US17031300500,17031300500,"Census Tract 3005, Cook County, Illinois",3015,201,64,119,0,18,0,0,0,0,0,2814,1951,0,0,0,0,838,25,13,12,0.978772803
1400000US17031300600,17031300600,"Census Tract 3006, Cook County, Illinois",3398,486,77,400,0,3,0,0,6,0,6,2912,1930,31,17,0,0,883,51,41,10,0.977339612
1400000US17031300700,17031300700,"Census Tract 3007, Cook County, Illinois",4694,150,110,40,0,0,0,0,0,0,0,4544,3212,0,43,0,0,1279,10,10,0,0.976565829
1400000US17031300800,17031300800,"Census Tract 3008, Cook County, Illinois",4674,41,24,17,0,0,0,0,0,0,0,4633,2958,0,0,0,0,1646,29,29,0,0.994865212
1400000US17031300900,17031300900,"Census Tract 3009, Cook County, Illinois",3963,211,49,83,0,1,0,0,78,0,78,3752,2886,11,11,0,0,844,0,0,0,0.98763563
1400000US17031301100,17031301100,"Census Tract 3011, Cook County, Illinois",3182,166,63,96,0,0,0,0,7,0,7,3016,1795,0,32,0,0,1189,0,0,0,0.980201131
1400000US17031301200,17031301200,"Census Tract 3012, Cook County, Illinois",3518,646,228,268,72,57,0,0,21,0,21,2872,1849,0,63,0,0,960,0,0,0,0.935190449
1400000US17031301600,17031301600,"Census Tract 3016, Cook County, Illinois",4513,145,51,92,0,2,0,0,0,0,0,4368,3192,0,0,0,0,1150,26,18,8,0.988699313
1400000US17031301701,17031301701,"Census Tract 3017.01, Cook County, Illinois",3744,147,145,2,0,0,0,0,0,0,0,3597,3208,0,0,0,0,389,0,0,0,0.961271368
1400000US17031301702,17031301702,"Census Tract 3017.02, Cook County, Illinois",3694,99,99,0,0,0,0,0,0,0,0,3595,2672,0,0,0,0,923,0,0,0,0.973199783
1400000US17031301801,17031301801,"Census Tract 3018.01, Cook County, Illinois",4246,341,60,281,0,0,0,0,0,0,0,3905,3161,0,0,0,0,744,0,0,0,0.985869053
1400000US17031301802,17031301802,"Census Tract 3018.02, Cook County, Illinois",2897,59,40,13,0,0,0,0,6,0,6,2838,1920,0,15,0,0,878,25,16,9,0.986192613
1400000US17031301803,17031301803,"Census Tract 3018.03, Cook County, Illinois",5054,214,76,115,0,12,0,0,11,11,0,4840,3038,0,0,0,0,1687,115,55,60,0.984962406
1400000US17031310200,17031310200,"Census Tract 3102, Cook County, Illinois",1526,661,517,46,0,66,0,0,32,0,32,865,527,0,0,0,0,314,24,24,0,0.661205767
1400000US17031310300,17031310300,"Census Tract 3103, Cook County, Illinois",1493,619,362,72,0,143,0,0,42,0,42,874,330,13,4,4,0,483,40,30,10,0.757535164
1400000US17031310400,17031310400,"Census Tract 3104, Cook County, Illinois",1426,373,236,87,0,35,0,0,15,0,15,1053,697,0,0,0,0,356,0,0,0,0.834502104
1400000US17031310500,17031310500,"Census Tract 3105, Cook County, Illinois",1722,82,70,0,2,0,0,0,10,0,10,1640,857,6,0,3,0,750,24,24,0,0.959349593
1400000US17031310600,17031310600,"Census Tract 3106, Cook County, Illinois",5141,1303,743,442,0,64,0,0,54,0,54,3838,1988,0,0,0,0,1759,91,44,47,0.855475588
1400000US17031310700,17031310700,"Census Tract 3107, Cook County, Illinois",1241,290,227,58,0,0,0,0,5,0,5,951,540,4,0,18,0,389,0,0,0,0.817082998
1400000US17031310800,17031310800,"Census Tract 3108, Cook County, Illinois",4734,516,443,50,0,0,0,0,23,0,23,4218,2284,0,9,0,0,1838,87,77,10,0.906421631
1400000US17031310900,17031310900,"Census Tract 3109, Cook County, Illinois",5065,690,543,87,0,18,0,0,42,0,42,4375,2520,19,0,0,0,1836,0,0,0,0.892793682
1400000US17031320100,17031320100,"Census Tract 3201, Cook County, Illinois",10534,9727,7155,812,58,1614,0,0,88,0,88,807,561,2,16,0,0,154,74,56,18,0.320770837
1400000US17031320400,17031320400,"Census Tract 3204, Cook County, Illinois",2523,2432,1612,380,0,351,12,0,77,32,45,91,35,7,0,0,0,41,8,8,0,0.361078082
1400000US17031320600,17031320600,"Census Tract 3206, Cook County, Illinois",4451,4274,2580,789,9,800,0,0,96,0,96,177,89,0,0,0,0,88,0,0,0,0.420354976
1400000US17031330100,17031330100,"Census Tract 3301, Cook County, Illinois",17582,16353,8289,4098,0,3463,0,0,503,100,403,1229,475,0,0,0,0,507,247,135,112,0.528551928
1400000US17031330200,17031330200,"Census Tract 3302, Cook County, Illinois",3756,3561,1682,1111,25,610,0,0,133,16,117,195,120,10,0,13,0,16,36,36,0,0.552183174
1400000US17031340300,17031340300,"Census Tract 3403, Cook County, Illinois",1734,1658,274,20,0,1315,0,0,49,0,49,76,76,0,0,0,0,0,0,0,0,0.841983852
1400000US17031340400,17031340400,"Census Tract 3404, Cook County, Illinois",1740,1664,212,2,0,1305,65,0,80,51,29,76,13,0,0,0,0,62,1,1,0,0.87816092
1400000US17031340500,17031340500,"Census Tract 3405, Cook County, Illinois",1688,1337,786,112,0,439,0,0,0,0,0,351,211,35,4,0,0,101,0,0,0,0.53436019
1400000US17031340600,17031340600,"Census Tract 3406, Cook County, Illinois",1066,1063,0,1043,0,0,0,0,20,0,20,3,3,0,0,0,0,0,0,0,0,1
1400000US17031350100,17031350100,"Census Tract 3501, Cook County, Illinois",1989,1924,137,1117,0,610,0,0,60,8,52,65,32,0,8,0,0,25,0,0,0,0.931121166
1400000US17031350400,17031350400,"Census Tract 3504, Cook County, Illinois",1379,1327,21,1264,0,0,0,9,33,0,33,52,0,4,0,0,0,48,0,0,0,0.984771574
1400000US17031351000,17031351000,"Census Tract 3510, Cook County, Illinois",4022,4022,138,2962,0,901,0,0,21,10,11,0,0,0,0,0,0,0,0,0,0,0.965688712
1400000US17031351100,17031351100,"Census Tract 3511, Cook County, Illinois",1656,1656,14,1623,0,0,9,0,10,0,10,0,0,0,0,0,0,0,0,0,0,0.991545894
1400000US17031351400,17031351400,"Census Tract 3514, Cook County, Illinois",1551,1551,68,1464,0,5,0,0,14,14,0,0,0,0,0,0,0,0,0,0,0,0.956157318
1400000US17031351500,17031351500,"Census Tract 3515, Cook County, Illinois",415,405,65,203,0,137,0,0,0,0,0,10,10,0,0,0,0,0,0,0,0,0.843373494
1400000US17031360200,17031360200,"Census Tract 3602, Cook County, Illinois",1616,1616,0,1579,0,37,0,0,0,0,0,0,0,0,0,0,0,0,0,0,0,1
1400000US17031380100,17031380100,"Census Tract 3801, Cook County, Illinois",1822,1822,124,1656,17,1,0,0,24,0,24,0,0,0,0,0,0,0,0,0,0,0.93194292
1400000US17031380200,17031380200,"Census Tract 3802, Cook County, Illinois",1752,1705,92,1548,0,21,0,0,44,0,44,47,38,0,0,0,9,0,0,0,0,0.947488584
1400000US17031380500,17031380500,"Census Tract 3805, Cook County, Illinois",820,818,2,812,0,2,0,0,2,0,2,2,2,0,0,0,0,0,0,0,0,0.997560976
1400000US17031380700,17031380700,"Census Tract 3807, Cook County, Illinois",1216,1197,190,983,0,7,0,0,17,0,17,19,14,0,0,0,0,0,5,0,5,0.84375
1400000US17031381200,17031381200,"Census Tract 3812, Cook County, Illinois",1946,1888,6,1854,0,0,0,8,20,0,20,58,25,0,0,0,0,33,0,0,0,0.996916752
1400000US17031381400,17031381400,"Census Tract 3814, Cook County, Illinois",1746,1741,0,1741,0,0,0,0,0,0,0,5,5,0,0,0,0,0,0,0,0,1
1400000US17031381500,17031381500,"Census Tract 3815, Cook County, Illinois",250,238,16,214,0,8,0,0,0,0,0,12,12,0,0,0,0,0,0,0,0,0.936
1400000US17031381700,17031381700,"Census Tract 3817, Cook County, Illinois",0,0,0,0,0,0,0,0,0,0,0,0,0,0,0,0,0,0,0,0,0,
1400000US17031381800,17031381800,"Census Tract 3818, Cook County, Illinois",1102,978,72,859,6,5,0,0,36,0,36,124,1,14,0,0,0,102,7,0,7,0.934664247
1400000US17031381900,17031381900,"Census Tract 3819, Cook County, Illinois",1293,1265,70,1185,0,0,0,0,10,0,10,28,22,6,0,0,0,0,0,0,0,0.945862336
1400000US17031390100,17031390100,"Census Tract 3901, Cook County, Illinois",1386,1306,23,1266,0,3,0,0,14,0,14,80,27,0,0,0,0,0,53,31,22,0.983405483
1400000US17031390200,17031390200,"Census Tract 3902, Cook County, Illinois",1637,1620,141,1421,0,46,0,0,12,0,12,17,17,0,0,0,0,0,0,0,0,0.91386683
1400000US17031390300,17031390300,"Census Tract 3903, Cook County, Illinois",2909,2868,229,2591,0,2,0,31,15,0,15,41,0,8,0,0,0,0,33,0,33,0.92127879
1400000US17031390400,17031390400,"Census Tract 3904, Cook County, Illinois",2524,2472,149,2266,13,18,0,0,26,0,26,52,52,0,0,0,0,0,0,0,0,0.940966719
1400000US17031390500,17031390500,"Census Tract 3905, Cook County, Illinois",1643,1569,341,1054,16,142,0,0,16,0,16,74,8,45,0,0,0,21,0,0,0,0.79245283
1400000US17031390600,17031390600,"Census Tract 3906, Cook County, Illinois",1976,1870,838,831,0,97,0,0,104,0,104,106,15,0,0,0,0,32,59,44,15,0.575910931
1400000US17031390700,17031390700,"Census Tract 3907, Cook County, Illinois",6142,5811,1515,2933,0,1184,0,78,101,36,65,331,219,78,0,0,0,34,0,0,0,0.753337675
1400000US17031400300,17031400300,"Census Tract 4003, Cook County, Illinois",1329,1305,20,1272,0,6,0,0,7,0,7,24,8,0,0,0,0,16,0,0,0,0.984951091
1400000US17031400400,17031400400,"Census Tract 4004, Cook County, Illinois",1661,1646,2,1629,0,0,0,0,15,0,15,15,0,15,0,0,0,0,0,0,0,0.998795906
1400000US17031400500,17031400500,"Census Tract 4005, Cook County, Illinois",2422,2422,0,2404,0,0,0,0,18,0,18,0,0,0,0,0,0,0,0,0,0,1
1400000US17031400800,17031400800,"Census Tract 4008, Cook County, Illinois",2839,2838,0,2672,120,0,0,0,46,0,46,1,1,0,0,0,0,0,0,0,0,1
1400000US17031410100,17031410100,"Census Tract 4101, Cook County, Illinois",1956,1562,447,907,0,155,0,0,53,0,53,394,101,8,0,0,0,272,13,13,0,0.771472393
1400000US17031410200,17031410200,"Census Tract 4102, Cook County, Illinois",1248,1202,507,242,0,354,0,0,99,10,89,46,31,6,0,0,0,9,0,0,0,0.59375
1400000US17031410500,17031410500,"Census Tract 4105, Cook County, Illinois",2630,2462,719,1359,0,322,0,0,62,0,62,168,100,0,0,0,0,46,22,7,15,0.72661597
1400000US17031410600,17031410600,"Census Tract 4106, Cook County, Illinois",2365,2328,1276,759,0,178,0,0,115,0,115,37,24,0,0,0,0,13,0,0,0,0.460465116
1400000US17031410700,17031410700,"Census Tract 4107, Cook County, Illinois",1959,1850,1048,472,0,279,0,0,51,0,51,109,60,0,0,0,0,26,23,23,0,0.46503318
1400000US17031410800,17031410800,"Census Tract 4108, Cook County, Illinois",3201,2847,979,1381,0,378,0,14,95,0,95,354,30,25,0,0,0,291,8,0,8,0.694158076
1400000US17031410900,17031410900,"Census Tract 4109, Cook County, Illinois",2923,2673,1466,922,0,176,0,21,88,0,88,250,100,17,0,0,0,113,20,20,0,0.498460486
1400000US17031411000,17031411000,"Census Tract 4110, Cook County, Illinois",3313,3139,1682,1012,0,327,0,7,111,0,111,174,144,0,0,0,6,15,9,9,0,0.492303049
1400000US17031411100,17031411100,"Census Tract 4111, Cook County, Illinois",2246,2197,1611,136,3,410,0,6,31,0,31,49,31,0,0,0,0,8,10,5,5,0.282724844
1400000US17031411200,17031411200,"Census Tract 4112, Cook County, Illinois",1691,1666,1091,283,0,235,0,0,57,4,53,25,21,0,0,0,0,4,0,0,0,0.354819633
1400000US17031420100,17031420100,"Census Tract 4201, Cook County, Illinois",1224,1172,38,1104,0,19,0,0,11,0,11,52,34,18,0,0,0,0,0,0,0,0.968954248
1400000US17031420200,17031420200,"Census Tract 4202, Cook County, Illinois",1707,1683,271,1293,9,63,0,0,47,0,47,24,13,0,0,0,0,11,0,0,0,0.841241945
1400000US17031420300,17031420300,"Census Tract 4203, Cook County, Illinois",2275,2208,876,983,0,329,0,7,13,7,6,67,43,7,0,7,0,6,4,0,4,0.614945055
1400000US17031420400,17031420400,"Census Tract 4204, Cook County, Illinois",1216,1150,349,613,0,162,0,0,26,23,3,66,28,7,0,0,0,31,0,0,0,0.712993421
1400000US17031420500,17031420500,"Census Tract 4205, Cook County, Illinois",2099,2087,11,1936,0,35,0,0,105,0,105,12,0,12,0,0,0,0,0,0,0,0.994759409
1400000US17031420600,17031420600,"Census Tract 4206, Cook County, Illinois",2056,2044,105,1921,0,5,0,0,13,0,13,12,6,0,0,0,0,0,6,0,6,0.948929961
1400000US17031420700,17031420700,"Census Tract 4207, Cook County, Illinois",3050,3016,110,2887,0,0,0,0,19,19,0,34,1,0,0,0,0,11,22,22,0,0.963934426
1400000US17031420800,17031420800,"Census Tract 4208, Cook County, Illinois",2292,2221,47,2141,0,0,0,0,33,0,33,71,71,0,0,0,0,0,0,0,0,0.979493892
1400000US17031421200,17031421200,"Census Tract 4212, Cook County, Illinois",1707,1690,0,1690,0,0,0,0,0,0,0,17,0,0,0,17,0,0,0,0,0,1
1400000US17031430101,17031430101,"Census Tract 4301.01, Cook County, Illinois",3913,3827,49,3540,0,0,0,0,238,19,219,86,69,0,0,0,0,0,17,17,0,0.987477639
1400000US17031430102,17031430102,"Census Tract 4301.02, Cook County, Illinois",3414,3363,48,3273,1,0,0,0,41,0,41,51,0,0,20,0,0,31,0,0,0,0.985940246
1400000US17031430200,17031430200,"Census Tract 4302, Cook County, Illinois",4927,4774,65,4660,0,46,0,0,3,0,3,153,0,0,0,0,0,153,0,0,0,0.986807388
1400000US17031430300,17031430300,"Census Tract 4303, Cook County, Illinois",2262,2262,4,2254,0,0,0,0,4,0,4,0,0,0,0,0,0,0,0,0,0,0.998231653
1400000US17031430400,17031430400,"Census Tract 4304, Cook County, Illinois",3119,3091,56,2939,0,7,0,0,89,46,43,28,0,0,0,0,0,0,28,28,0,0.982045527
1400000US17031430500,17031430500,"Census Tract 4305, Cook County, Illinois",3661,3565,36,3470,0,0,0,0,59,0,59,96,13,44,0,0,0,39,0,0,0,0.990166621
1400000US17031430600,17031430600,"Census Tract 4306, Cook County, Illinois",1742,1742,41,1639,0,2,0,0,60,0,60,0,0,0,0,0,0,0,0,0,0,0.976463835
1400000US17031430700,17031430700,"Census Tract 4307, Cook County, Illinois",2480,2448,100,2286,28,16,0,0,18,18,0,32,8,0,0,0,0,17,7,0,7,0.959677419
1400000US17031430800,17031430800,"Census Tract 4308, Cook County, Illinois",1692,1689,54,1593,0,0,25,11,6,0,6,3,0,0,0,0,0,0,3,0,3,0.968085106
1400000US17031430900,17031430900,"Census Tract 4309, Cook County, Illinois",1345,1345,19,1314,0,6,0,0,6,0,6,0,0,0,0,0,0,0,0,0,0,0.985873606
1400000US17031431200,17031431200,"Census Tract 4312, Cook County, Illinois",3291,3192,66,3099,0,0,0,0,27,0,27,99,0,7,0,0,0,78,14,14,0,0.979945305
1400000US17031431301,17031431301,"Census Tract 4313.01, Cook County, Illinois",3421,3380,63,3176,41,0,0,0,100,0,100,41,25,0,0,0,0,15,1,0,1,0.981584332
1400000US17031431302,17031431302,"Census Tract 4313.02, Cook County, Illinois",3401,3223,3,3070,0,0,0,0,150,31,119,178,36,97,0,0,0,3,42,42,0,0.999117906
1400000US17031431400,17031431400,"Census Tract 4314, Cook County, Illinois",5850,5720,272,5373,0,8,0,0,67,30,37,130,98,24,0,0,0,8,0,0,0,0.953504274
1400000US17031440101,17031440101,"Census Tract 4401.01, Cook County, Illinois",3747,3650,56,3492,0,80,0,9,13,0,13,97,0,49,0,0,0,0,48,48,0,0.98505471
1400000US17031440102,17031440102,"Census Tract 4401.02, Cook County, Illinois",3156,3138,14,3093,0,0,19,0,12,0,12,18,1,17,0,0,0,0,0,0,0,0.995564005
1400000US17031440201,17031440201,"Census Tract 4402.01, Cook County, Illinois",5343,5277,15,5216,0,0,0,16,30,13,17,66,13,53,0,0,0,0,0,0,0,0.997192588
1400000US17031440202,17031440202,"Census Tract 4402.02, Cook County, Illinois",3604,3585,7,3534,0,0,0,0,44,0,44,19,0,0,0,0,0,19,0,0,0,0.998057714
1400000US17031440300,17031440300,"Census Tract 4403, Cook County, Illinois",4455,4454,85,4230,0,1,0,0,138,0,138,1,1,0,0,0,0,0,0,0,0,0.980920314
1400000US17031440600,17031440600,"Census Tract 4406, Cook County, Illinois",2056,2045,19,2026,0,0,0,0,0,0,0,11,4,0,0,0,0,7,0,0,0,0.990758755
1400000US17031440700,17031440700,"Census Tract 4407, Cook County, Illinois",1501,1501,3,1467,0,9,0,0,22,0,22,0,0,0,0,0,0,0,0,0,0,0.998001332
1400000US17031440800,17031440800,"Census Tract 4408, Cook County, Illinois",1777,1760,0,1757,0,0,0,0,3,0,3,17,0,0,0,0,0,17,0,0,0,1
1400000US17031440900,17031440900,"Census Tract 4409, Cook County, Illinois",2480,2479,3,2447,0,0,0,0,29,0,29,1,0,1,0,0,0,0,0,0,0,0.998790323
1400000US17031450300,17031450300,"Census Tract 4503, Cook County, Illinois",3716,3701,174,3503,0,0,0,10,14,0,14,15,0,15,0,0,0,0,0,0,0,0.953175457
1400000US17031460100,17031460100,"Census Tract 4601, Cook County, Illinois",3614,2692,159,2359,0,0,0,0,174,0,174,922,651,190,0,0,0,81,0,0,0,0.956004427
1400000US17031460200,17031460200,"Census Tract 4602, Cook County, Illinois",2626,1449,78,1371,0,0,0,0,0,0,0,1177,992,10,0,0,0,175,0,0,0,0.97029703
1400000US17031460301,17031460301,"Census Tract 4603.01, Cook County, Illinois",2639,1851,55,1788,0,0,8,0,0,0,0,788,470,23,0,0,0,263,32,32,0,0.979158772
1400000US17031460302,17031460302,"Census Tract 4603.02, Cook County, Illinois",3506,3291,32,3187,0,72,0,0,0,0,0,215,115,0,0,0,0,54,46,46,0,0.99087279
1400000US17031460400,17031460400,"Census Tract 4604, Cook County, Illinois",3154,3154,54,3100,0,0,0,0,0,0,0,0,0,0,0,0,0,0,0,0,0,0.982878884
1400000US17031460500,17031460500,"Census Tract 4605, Cook County, Illinois",4798,4759,115,4579,0,0,0,0,65,0,65,39,0,0,0,0,0,0,39,39,0,0.97603168
1400000US17031460600,17031460600,"Census Tract 4606, Cook County, Illinois",1107,922,166,756,0,0,0,0,0,0,0,185,119,9,0,0,0,57,0,0,0,0.850045167
1400000US17031460700,17031460700,"Census Tract 4607, Cook County, Illinois",2901,1856,69,1739,0,34,0,0,14,12,2,1045,782,0,0,0,0,209,54,54,0,0.976215098
1400000US17031461000,17031461000,"Census Tract 4610, Cook County, Illinois",2034,1033,132,889,0,0,0,12,0,0,0,1001,693,130,17,0,0,142,19,19,0,0.935103245
1400000US17031470100,17031470100,"Census Tract 4701, Cook County, Illinois",2618,2618,0,2618,0,0,0,0,0,0,0,0,0,0,0,0,0,0,0,0,0,1
1400000US17031480100,17031480100,"Census Tract 4801, Cook County, Illinois",2045,2045,51,1983,8,0,0,3,0,0,0,0,0,0,0,0,0,0,0,0,0,0.975061125
1400000US17031480200,17031480200,"Census Tract 4802, Cook County, Illinois",1157,1157,0,1151,0,0,0,0,6,0,6,0,0,0,0,0,0,0,0,0,0,1
1400000US17031480300,17031480300,"Census Tract 4803, Cook County, Illinois",1192,1125,11,1102,0,5,0,0,7,0,7,67,12,35,0,0,0,14,6,6,0,0.990771812
1400000US17031480400,17031480400,"Census Tract 4804, Cook County, Illinois",6106,6059,98,5870,0,14,0,0,77,0,77,47,0,18,0,0,0,29,0,0,0,0.983950213
1400000US17031480500,17031480500,"Census Tract 4805, Cook County, Illinois",2900,2495,109,2356,0,0,0,0,30,0,30,405,176,0,0,0,0,229,0,0,0,0.962413793
1400000US17031490300,17031490300,"Census Tract 4903, Cook County, Illinois",2290,2241,12,2151,0,0,0,0,78,0,78,49,6,11,0,0,0,0,32,32,0,0.994759825
1400000US17031490400,17031490400,"Census Tract 4904, Cook County, Illinois",972,972,0,954,0,18,0,0,0,0,0,0,0,0,0,0,0,0,0,0,0,1
1400000US17031490500,17031490500,"Census Tract 4905, Cook County, Illinois",2340,2280,87,2119,0,43,0,0,31,6,25,60,7,53,0,0,0,0,0,0,0,0.962820513
1400000US17031490600,17031490600,"Census Tract 4906, Cook County, Illinois",1452,1451,6,1429,0,0,0,0,16,0,16,1,1,0,0,0,0,0,0,0,0,0.995867769
1400000US17031490700,17031490700,"Census Tract 4907, Cook County, Illinois",2888,2888,21,2846,0,9,0,0,12,0,12,0,0,0,0,0,0,0,0,0,0,0.992728532
1400000US17031490800,17031490800,"Census Tract 4908, Cook County, Illinois",3769,3745,18,3629,0,0,0,25,73,25,48,24,24,0,0,0,0,0,0,0,0,0.995224197
1400000US17031490901,17031490901,"Census Tract 4909.01, Cook County, Illinois",4215,4213,81,4068,0,29,0,0,35,0,35,2,1,1,0,0,0,0,0,0,0,0.980782918
1400000US17031490902,17031490902,"Census Tract 4909.02, Cook County, Illinois",4825,4818,23,4775,0,20,0,0,0,0,0,7,7,0,0,0,0,0,0,0,0,0.995233161
1400000US17031491000,17031491000,"Census Tract 4910, Cook County, Illinois",5536,5490,52,5429,0,1,0,0,8,0,8,46,0,46,0,0,0,0,0,0,0,0.990606936
1400000US17031491100,17031491100,"Census Tract 4911, Cook County, Illinois",4577,4506,89,4417,0,0,0,0,0,0,0,71,0,47,0,0,0,24,0,0,0,0.980554949
1400000US17031491200,17031491200,"Census Tract 4912, Cook County, Illinois",2746,2732,9,2693,0,30,0,0,0,0,0,14,0,0,0,0,0,14,0,0,0,0.996722505
1400000US17031491300,17031491300,"Census Tract 4913, Cook County, Illinois",2343,2270,34,2192,0,0,0,0,44,0,44,73,40,33,0,0,0,0,0,0,0,0.98548869
1400000US17031491400,17031491400,"Census Tract 4914, Cook County, Illinois",2698,2603,39,2564,0,0,0,0,0,0,0,95,0,53,0,0,0,0,42,42,0,0.985544848
1400000US17031500100,17031500100,"Census Tract 5001, Cook County, Illinois",3314,3290,35,3235,0,14,0,0,6,0,6,24,6,10,0,0,0,8,0,0,0,0.989438745
1400000US17031500200,17031500200,"Census Tract 5002, Cook County, Illinois",2091,2075,21,2016,0,28,0,0,10,0,10,16,8,0,0,0,0,8,0,0,0,0.989956958
1400000US17031500300,17031500300,"Census Tract 5003, Cook County, Illinois",1565,1035,549,484,0,0,0,0,2,0,2,530,336,28,0,0,0,155,11,11,0,0.649201278
1400000US17031510100,17031510100,"Census Tract 5101, Cook County, Illinois",3646,620,373,247,0,0,0,0,0,0,0,3026,1417,91,11,0,0,1424,83,33,50,0.897696105
1400000US17031510200,17031510200,"Census Tract 5102, Cook County, Illinois",2655,2153,121,2007,0,9,0,0,16,0,16,502,385,0,0,0,0,117,0,0,0,0.954425612
1400000US17031510300,17031510300,"Census Tract 5103, Cook County, Illinois",6037,6022,44,5814,0,27,0,0,137,0,137,15,0,0,0,0,15,0,0,0,0,0.992711612
1400000US17031520100,17031520100,"Census Tract 5201, Cook County, Illinois",2278,279,177,82,20,0,0,0,0,0,0,1999,1672,87,0,0,0,235,5,0,5,0.922300263
1400000US17031520200,17031520200,"Census Tract 5202, Cook County, Illinois",3987,622,373,249,0,0,0,0,0,0,0,3365,2775,36,0,0,0,498,56,39,17,0.906445949
1400000US17031520300,17031520300,"Census Tract 5203, Cook County, Illinois",6116,735,663,20,0,25,0,0,27,9,18,5381,4623,0,36,0,0,613,109,105,4,0.891595814
1400000US17031520400,17031520400,"Census Tract 5204, Cook County, Illinois",3735,558,504,46,0,0,0,0,8,8,0,3177,2029,127,21,0,0,867,133,108,25,0.865060241
1400000US17031520500,17031520500,"Census Tract 5205, Cook County, Illinois",4613,1745,1717,1,0,9,0,0,18,0,18,2868,2523,22,36,0,0,262,25,25,0,0.627791025
1400000US17031520600,17031520600,"Census Tract 5206, Cook County, Illinois",3010,652,652,0,0,0,0,0,0,0,0,2358,1916,0,18,0,0,391,33,33,0,0.783388704
1400000US17031530100,17031530100,"Census Tract 5301, Cook County, Illinois",2091,1075,117,951,7,0,0,0,0,0,0,1016,632,33,12,0,0,339,0,0,0,0.944045911
1400000US17031530200,17031530200,"Census Tract 5302, Cook County, Illinois",4893,4893,0,4860,0,0,0,0,33,9,24,0,0,0,0,0,0,0,0,0,0,1
1400000US17031530300,17031530300,"Census Tract 5303, Cook County, Illinois",4453,4413,53,4318,0,0,0,0,42,10,32,40,40,0,0,0,0,0,0,0,0,0.988097912
1400000US17031530400,17031530400,"Census Tract 5304, Cook County, Illinois",2017,1996,10,1972,0,14,0,0,0,0,0,21,0,0,0,0,0,21,0,0,0,0.995042142
1400000US17031530501,17031530501,"Census Tract 5305.01, Cook County, Illinois",5192,5161,79,4933,0,0,0,0,149,0,149,31,17,14,0,0,0,0,0,0,0,0.984784284
1400000US17031530502,17031530502,"Census Tract 5305.02, Cook County, Illinois",1495,1495,8,1478,0,0,0,0,9,9,0,0,0,0,0,0,0,0,0,0,0,0.994648829
1400000US17031530503,17031530503,"Census Tract 5305.03, Cook County, Illinois",5147,5072,1,5029,0,37,0,0,5,0,5,75,67,0,0,0,0,0,8,0,8,0.999805712
1400000US17031530600,17031530600,"Census Tract 5306, Cook County, Illinois",2872,2780,11,2756,13,0,0,0,0,0,0,92,82,10,0,0,0,0,0,0,0,0.996169916
1400000US17031540101,17031540101,"Census Tract 5401.01, Cook County, Illinois",3922,3827,0,3809,16,0,0,0,2,0,2,95,72,23,0,0,0,0,0,0,0,1
1400000US17031540102,17031540102,"Census Tract 5401.02, Cook County, Illinois",3268,3183,74,3101,0,0,0,0,8,0,8,85,0,0,0,0,0,85,0,0,0,0.977356181
1400000US17031550100,17031550100,"Census Tract 5501, Cook County, Illinois",6759,3242,2843,365,0,16,0,0,18,0,18,3517,2870,51,63,17,0,319,197,197,0,0.579375647
1400000US17031550200,17031550200,"Census Tract 5502, Cook County, Illinois",2579,1209,1128,43,0,0,0,0,38,0,38,1370,1211,0,0,0,0,110,49,0,49,0.562621171
1400000US17031560100,17031560100,"Census Tract 5601, Cook County, Illinois",1263,521,274,48,0,164,0,0,35,0,35,742,541,43,0,2,0,156,0,0,0,0.783056215
1400000US17031560200,17031560200,"Census Tract 5602, Cook County, Illinois",1510,1323,227,1071,6,9,0,0,10,0,10,187,135,0,0,0,0,52,0,0,0,0.849668874
1400000US17031560300,17031560300,"Census Tract 5603, Cook County, Illinois",3174,1428,995,279,0,150,0,0,4,0,4,1746,670,0,0,35,0,989,52,4,48,0.686515438
1400000US17031560400,17031560400,"Census Tract 5604, Cook County, Illinois",1417,544,448,0,12,84,0,0,0,0,0,873,591,18,0,0,0,240,24,0,24,0.683839097
1400000US17031560700,17031560700,"Census Tract 5607, Cook County, Illinois",3486,1776,1726,5,0,0,0,0,45,45,0,1710,1002,0,0,0,0,553,155,140,15,0.504876649
1400000US17031560800,17031560800,"Census Tract 5608, Cook County, Illinois",5937,2859,2805,32,0,0,0,0,22,0,22,3078,1950,0,0,6,0,821,301,133,168,0.527539161
1400000US17031560900,17031560900,"Census Tract 5609, Cook County, Illinois",5377,3682,3562,20,0,46,0,0,54,0,54,1695,879,0,0,0,0,701,115,115,0,0.337548819
1400000US17031561000,17031561000,"Census Tract 5610, Cook County, Illinois",4892,2946,2830,0,0,0,0,0,116,33,83,1946,1338,0,0,0,0,608,0,0,0,0.421504497
1400000US17031561100,17031561100,"Census Tract 5611, Cook County, Illinois",5816,3604,3604,0,0,0,0,0,0,0,0,2212,1366,0,0,0,0,731,115,108,7,0.380330124
1400000US17031570100,17031570100,"Census Tract 5701, Cook County, Illinois",1296,313,203,0,0,81,0,0,29,3,26,983,710,3,5,0,0,239,26,18,8,0.843364198
1400000US17031570200,17031570200,"Census Tract 5702, Cook County, Illinois",1878,528,464,0,12,52,0,0,0,0,0,1350,910,8,0,0,0,393,39,39,0,0.752928647
1400000US17031570300,17031570300,"Census Tract 5703, Cook County, Illinois",6337,1491,1391,16,0,66,0,0,18,0,18,4846,2718,0,0,0,0,1970,158,138,20,0.780495503
1400000US17031570400,17031570400,"Census Tract 5704, Cook County, Illinois",1933,353,317,15,0,1,0,0,20,0,20,1580,832,0,40,0,0,708,0,0,0,0.836006208
1400000US17031570500,17031570500,"Census Tract 5705, Cook County, Illinois",2554,728,515,80,0,133,0,0,0,0,0,1826,897,0,0,0,0,929,0,0,0,0.798355521
1400000US17031580100,17031580100,"Census Tract 5801, Cook County, Illinois",2996,908,265,0,0,643,0,0,0,0,0,2088,1437,15,0,0,0,624,12,12,0,0.911548732
1400000US17031580200,17031580200,"Census Tract 5802, Cook County, Illinois",3382,577,253,60,0,264,0,0,0,0,0,2805,1642,11,10,0,0,1066,76,49,27,0.925192194
1400000US17031580300,17031580300,"Census Tract 5803, Cook County, Illinois",2334,217,26,0,0,191,0,0,0,0,0,2117,1265,0,142,0,0,710,0,0,0,0.988860326
1400000US17031580400,17031580400,"Census Tract 5804, Cook County, Illinois",4051,913,298,114,0,501,0,0,0,0,0,3138,2090,9,0,0,0,981,58,0,58,0.926437917
1400000US17031580501,17031580501,"Census Tract 5805.01, Cook County, Illinois",5059,816,469,86,0,239,0,0,22,0,22,4243,2800,11,0,0,0,1391,41,8,33,0.907293932
1400000US17031580502,17031580502,"Census Tract 5805.02, Cook County, Illinois",4893,792,480,91,0,221,0,0,0,0,0,4101,2961,0,52,0,0,981,107,107,0,0.901900674
1400000US17031580600,17031580600,"Census Tract 5806, Cook County, Illinois",5824,617,259,91,0,267,0,0,0,0,0,5207,3762,0,0,0,0,1416,29,20,9,0.955528846
1400000US17031580700,17031580700,"Census Tract 5807, Cook County, Illinois",6292,758,370,40,0,337,0,0,11,0,11,5534,3627,0,19,9,0,1879,0,0,0,0.941195168
1400000US17031580800,17031580800,"Census Tract 5808, Cook County, Illinois",1661,131,110,21,0,0,0,0,0,0,0,1530,1050,4,29,0,0,439,8,8,0,0.933774834
1400000US17031590500,17031590500,"Census Tract 5905, Cook County, Illinois",1842,1013,349,38,0,626,0,0,0,0,0,829,602,5,5,0,0,194,23,20,3,0.81053203
1400000US17031590600,17031590600,"Census Tract 5906, Cook County, Illinois",3954,1363,861,53,0,421,0,18,10,0,10,2591,1151,0,123,0,0,1210,107,53,54,0.782245827
1400000US17031590700,17031590700,"Census Tract 5907, Cook County, Illinois",3234,1011,454,119,0,342,0,0,96,0,96,2223,1422,5,60,0,0,735,1,1,0,0.859616574
1400000US17031600400,17031600400,"Census Tract 6004, Cook County, Illinois",4748,3827,1054,17,0,2564,0,36,156,0,156,921,605,0,31,0,0,238,47,0,47,0.778011794
1400000US17031600600,17031600600,"Census Tract 6006, Cook County, Illinois",2494,1548,461,0,95,951,0,0,41,0,41,946,548,67,0,0,0,331,0,0,0,0.815156375
1400000US17031600700,17031600700,"Census Tract 6007, Cook County, Illinois",2200,1516,826,127,0,504,0,0,59,0,59,684,486,0,17,0,0,181,0,0,0,0.624545455
1400000US17031600900,17031600900,"Census Tract 6009, Cook County, Illinois",3658,2669,1264,508,0,884,0,0,13,0,13,989,477,0,0,0,0,373,139,116,23,0.654455987
1400000US17031610300,17031610300,"Census Tract 6103, Cook County, Illinois",5717,906,344,311,0,251,0,0,0,0,0,4811,3174,0,3,0,0,1420,214,214,0,0.939828581
1400000US17031610400,17031610400,"Census Tract 6104, Cook County, Illinois",1897,89,51,38,0,0,0,0,0,0,0,1808,1087,0,72,0,0,625,24,12,12,0.973115445
1400000US17031610800,17031610800,"Census Tract 6108, Cook County, Illinois",1549,1294,1255,17,0,0,0,0,22,0,22,255,220,0,0,0,0,35,0,0,0,0.189799871
1400000US17031611000,17031611000,"Census Tract 6110, Cook County, Illinois",1188,682,53,629,0,0,0,0,0,0,0,506,392,0,0,0,0,114,0,0,0,0.955387205
1400000US17031611100,17031611100,"Census Tract 6111, Cook County, Illinois",2658,694,62,602,0,0,0,11,19,0,19,1964,1334,0,0,0,0,625,5,0,5,0.976674191
1400000US17031611200,17031611200,"Census Tract 6112, Cook County, Illinois",2340,673,132,527,0,12,0,0,2,0,2,1667,1187,0,0,0,0,467,13,13,0,0.943589744
1400000US17031611300,17031611300,"Census Tract 6113, Cook County, Illinois",2768,708,220,429,0,0,0,0,59,0,59,2060,1255,90,0,0,0,715,0,0,0,0.920520231
1400000US17031611400,17031611400,"Census Tract 6114, Cook County, Illinois",3544,336,159,141,0,0,0,0,36,14,22,3208,1730,0,16,0,0,1450,12,12,0,0.95513544
1400000US17031611500,17031611500,"Census Tract 6115, Cook County, Illinois",2978,434,145,257,21,4,0,0,7,0,7,2544,1582,0,0,0,0,962,0,0,0,0.951309604
1400000US17031611600,17031611600,"Census Tract 6116, Cook County, Illinois",1529,980,0,980,0,0,0,0,0,0,0,549,370,0,0,0,0,179,0,0,0,1
1400000US17031611700,17031611700,"Census Tract 6117, Cook County, Illinois",1335,953,0,912,0,0,0,0,41,0,41,382,260,0,0,0,0,122,0,0,0,1
1400000US17031611800,17031611800,"Census Tract 6118, Cook County, Illinois",2443,1329,37,1229,0,0,0,0,63,12,51,1114,456,0,0,0,0,640,18,18,0,0.984854687
1400000US17031611900,17031611900,"Census Tract 6119, Cook County, Illinois",2154,1875,98,1742,0,0,0,0,35,0,35,279,214,0,0,0,0,46,19,0,19,0.95450325
1400000US17031612000,17031612000,"Census Tract 6120, Cook County, Illinois",1586,1432,5,1415,0,0,0,10,2,0,2,154,0,20,0,0,0,134,0,0,0,0.996847415
1400000US17031612100,17031612100,"Census Tract 6121, Cook County, Illinois",1068,1039,66,936,0,37,0,0,0,0,0,29,29,0,0,0,0,0,0,0,0,0.938202247
1400000US17031620100,17031620100,"Census Tract 6201, Cook County, Illinois",4765,853,742,0,0,92,0,0,19,0,19,3912,2103,71,39,0,0,1640,59,0,59,0.844281217
1400000US17031620200,17031620200,"Census Tract 6202, Cook County, Illinois",2443,736,673,9,0,54,0,0,0,0,0,1707,1157,0,0,0,0,524,26,0,26,0.724519034
1400000US17031620300,17031620300,"Census Tract 6203, Cook County, Illinois",7050,1831,1660,89,0,82,0,0,0,0,0,5219,2486,0,0,0,0,2632,101,45,56,0.764539007
1400000US17031620400,17031620400,"Census Tract 6204, Cook County, Illinois",4907,391,322,35,0,29,0,0,5,0,5,4516,2457,5,0,0,0,2025,29,29,0,0.934379458
1400000US17031630100,17031630100,"Census Tract 6301, Cook County, Illinois",1135,202,36,166,0,0,0,0,0,0,0,933,634,21,4,0,0,274,0,0,0,0.968281938
1400000US17031630200,17031630200,"Census Tract 6302, Cook County, Illinois",2217,169,85,13,0,71,0,0,0,0,0,2048,1090,64,0,0,0,865,29,29,0,0.961659901
1400000US17031630300,17031630300,"Census Tract 6303, Cook County, Illinois",5332,359,281,0,0,78,0,0,0,0,0,4973,3024,14,0,0,0,1864,71,71,0,0.947299325
1400000US17031630400,17031630400,"Census Tract 6304, Cook County, Illinois",6835,370,318,0,0,52,0,0,0,0,0,6465,2414,0,0,0,0,4036,15,15,0,0.953474762
1400000US17031630500,17031630500,"Census Tract 6305, Cook County, Illinois",6663,280,128,64,0,57,0,0,31,0,31,6383,2806,0,0,0,0,3552,25,25,0,0.980789434
1400000US17031630800,17031630800,"Census Tract 6308, Cook County, Illinois",7456,597,249,309,0,39,0,0,0,0,0,6859,3720,0,70,64,0,2911,94,94,0,0.966604077
1400000US17031630900,17031630900,"Census Tract 6309, Cook County, Illinois",5188,271,181,72,0,18,0,0,0,0,0,4917,1866,0,41,0,0,3010,0,0,0,0.965111796
1400000US17031640100,17031640100,"Census Tract 6401, Cook County, Illinois",1230,463,381,36,0,46,0,0,0,0,0,767,360,0,12,0,0,383,12,12,0,0.690243902
1400000US17031640300,17031640300,"Census Tract 6403, Cook County, Illinois",6947,3843,3800,0,0,21,0,0,22,0,22,3104,1155,0,0,0,0,1616,333,333,0,0.453001296
1400000US17031640400,17031640400,"Census Tract 6404, Cook County, Illinois",3653,1853,1811,0,6,36,0,0,0,0,0,1800,672,0,0,0,0,854,274,24,250,0.504243088
1400000US17031640500,17031640500,"Census Tract 6405, Cook County, Illinois",3183,2008,1860,32,0,65,0,0,51,0,51,1175,838,12,0,13,0,298,14,14,0,0.415645617
1400000US17031640600,17031640600,"Census Tract 6406, Cook County, Illinois",4432,2551,2350,0,0,146,0,0,55,0,55,1881,1006,0,0,0,0,875,0,0,0,0.469765343
1400000US17031640700,17031640700,"Census Tract 6407, Cook County, Illinois",3235,1269,1214,24,0,31,0,0,0,0,0,1966,933,0,7,0,0,827,199,121,78,0.624729521
1400000US17031640800,17031640800,"Census Tract 6408, Cook County, Illinois",1772,460,360,75,0,0,0,0,25,0,25,1312,661,0,0,5,0,646,0,0,0,0.796839729
1400000US17031650100,17031650100,"Census Tract 6501, Cook County, Illinois",4510,426,391,1,0,19,0,0,15,0,15,4084,1271,0,10,0,0,2571,232,221,11,0.913303769
1400000US17031650200,17031650200,"Census Tract 6502, Cook County, Illinois",7628,2184,2069,100,0,0,0,0,15,0,15,5444,2673,0,219,0,0,2516,36,0,36,0.728762454
1400000US17031650301,17031650301,"Census Tract 6503.01, Cook County, Illinois",5744,1082,962,2,0,99,0,0,19,0,19,4662,1973,0,11,0,0,2506,172,133,39,0.832520891
1400000US17031650302,17031650302,"Census Tract 6503.02, Cook County, Illinois",4148,633,487,146,0,0,0,0,0,0,0,3515,1383,0,9,0,0,2057,66,50,16,0.882594021
1400000US17031650400,17031650400,"Census Tract 6504, Cook County, Illinois",7284,1040,641,350,0,16,0,0,33,0,33,6244,1817,0,38,0,0,4389,0,0,0,0.911998902
1400000US17031650500,17031650500,"Census Tract 6505, Cook County, Illinois",4163,1186,800,333,0,9,0,0,44,11,33,2977,1495,0,57,0,0,1366,59,49,10,0.807830891
1400000US17031660301,17031660301,"Census Tract 6603.01, Cook County, Illinois",1790,852,5,780,0,0,0,0,67,0,67,938,200,0,0,0,0,712,26,26,0,0.997206704
1400000US17031660302,17031660302,"Census Tract 6603.02, Cook County, Illinois",5554,1056,178,878,0,0,0,0,0,0,0,4498,870,0,35,0,0,3438,155,134,21,0.967951026
1400000US17031660400,17031660400,"Census Tract 6604, Cook County, Illinois",5975,580,335,245,0,0,0,0,0,0,0,5395,1454,22,0,0,0,3919,0,0,0,0.943933054
1400000US17031660500,17031660500,"Census Tract 6605, Cook County, Illinois",5702,1091,276,815,0,0,0,0,0,0,0,4611,1472,15,26,0,0,3006,92,84,8,0.951595931
1400000US17031660600,17031660600,"Census Tract 6606, Cook County, Illinois",6164,4125,175,3873,0,10,0,0,67,0,67,2039,434,0,0,0,0,1490,115,115,0,0.971609345
1400000US17031660700,17031660700,"Census Tract 6607, Cook County, Illinois",2677,2637,53,2490,0,55,0,0,39,0,39,40,15,0,0,0,0,17,8,8,0,0.980201718
1400000US17031660800,17031660800,"Census Tract 6608, Cook County, Illinois",6517,3504,134,3293,0,0,0,24,53,0,53,3013,311,0,0,0,0,2702,0,0,0,0.979438392
1400000US17031660900,17031660900,"Census Tract 6609, Cook County, Illinois",4357,4074,214,3673,0,106,0,0,81,0,81,283,0,0,0,0,0,283,0,0,0,0.950883636
1400000US17031661000,17031661000,"Census Tract 6610, Cook County, Illinois",5717,5545,69,5220,0,191,0,0,65,0,65,172,89,62,0,0,0,21,0,0,0,0.987930733
1400000US17031661100,17031661100,"Census Tract 6611, Cook County, Illinois",6029,3372,291,3003,0,30,0,23,25,7,18,2657,1237,29,48,0,0,1212,131,122,9,0.951733289
1400000US17031670100,17031670100,"Census Tract 6701, Cook County, Illinois",1601,1550,75,1475,0,0,0,0,0,0,0,51,0,0,0,0,0,51,0,0,0,0.953154279
1400000US17031670200,17031670200,"Census Tract 6702, Cook County, Illinois",985,899,0,899,0,0,0,0,0,0,0,86,30,0,0,0,0,56,0,0,0,1
1400000US17031670300,17031670300,"Census Tract 6703, Cook County, Illinois",1381,1293,30,1263,0,0,0,0,0,0,0,88,6,0,0,0,0,82,0,0,0,0.978276611
1400000US17031670400,17031670400,"Census Tract 6704, Cook County, Illinois",1858,1635,35,1473,0,0,0,0,127,0,127,223,94,0,0,0,0,117,12,12,0,0.98116254
1400000US17031670500,17031670500,"Census Tract 6705, Cook County, Illinois",1040,918,10,897,0,11,0,0,0,0,0,122,0,14,0,0,0,108,0,0,0,0.990384615
1400000US17031670600,17031670600,"Census Tract 6706, Cook County, Illinois",1636,1553,2,1505,0,0,0,0,46,0,46,83,0,0,0,0,0,83,0,0,0,0.998777506
1400000US17031670700,17031670700,"Census Tract 6707, Cook County, Illinois",1547,1531,20,1496,0,0,0,0,15,5,10,16,6,10,0,0,0,0,0,0,0,0.987071752
1400000US17031670800,17031670800,"Census Tract 6708, Cook County, Illinois",1688,1688,0,1688,0,0,0,0,0,0,0,0,0,0,0,0,0,0,0,0,0,1
1400000US17031670900,17031670900,"Census Tract 6709, Cook County, Illinois",1496,1491,0,1445,15,0,0,0,31,0,31,5,0,0,0,0,0,5,0,0,0,1
1400000US17031671100,17031671100,"Census Tract 6711, Cook County, Illinois",1486,1486,5,1481,0,0,0,0,0,0,0,0,0,0,0,0,0,0,0,0,0,0.996635262
1400000US17031671200,17031671200,"Census Tract 6712, Cook County, Illinois",1063,1063,0,1033,0,0,0,0,30,0,30,0,0,0,0,0,0,0,0,0,0,1
1400000US17031671300,17031671300,"Census Tract 6713, Cook County, Illinois",2190,2190,1,2152,0,0,0,0,37,0,37,0,0,0,0,0,0,0,0,0,0,0.999543379
1400000US17031671400,17031671400,"Census Tract 6714, Cook County, Illinois",1864,1793,0,1793,0,0,0,0,0,0,0,71,32,21,0,0,0,5,13,13,0,1
1400000US17031671500,17031671500,"Census Tract 6715, Cook County, Illinois",3254,3068,15,3037,0,0,0,0,16,0,16,186,70,0,0,0,0,116,0,0,0,0.995390289
1400000US17031671600,17031671600,"Census Tract 6716, Cook County, Illinois",2291,2139,26,2080,0,0,0,0,33,0,33,152,0,0,0,0,0,152,0,0,0,0.988651244
1400000US17031671800,17031671800,"Census Tract 6718, Cook County, Illinois",1139,1137,0,1052,0,0,0,0,85,0,85,2,0,0,0,0,0,0,2,2,0,1
1400000US17031671900,17031671900,"Census Tract 6719, Cook County, Illinois",1313,1313,0,1310,0,0,0,0,3,0,3,0,0,0,0,0,0,0,0,0,0,1
1400000US17031672000,17031672000,"Census Tract 6720, Cook County, Illinois",4148,3954,25,3913,0,0,0,0,16,4,12,194,4,0,0,0,0,190,0,0,0,0.993972999
1400000US17031680500,17031680500,"Census Tract 6805, Cook County, Illinois",1285,1177,57,1120,0,0,0,0,0,0,0,108,53,0,0,0,0,55,0,0,0,0.955642023
1400000US17031680600,17031680600,"Census Tract 6806, Cook County, Illinois",1594,1594,36,1511,0,0,0,0,47,0,47,0,0,0,0,0,0,0,0,0,0,0.977415307
1400000US17031680900,17031680900,"Census Tract 6809, Cook County, Illinois",3389,3356,8,3293,32,4,0,0,19,0,19,33,17,0,0,7,0,0,9,0,9,0.997639422
1400000US17031681000,17031681000,"Census Tract 6810, Cook County, Illinois",2873,2796,25,2762,0,0,0,0,9,0,9,77,0,0,0,0,0,77,0,0,0,0.991298294
1400000US17031681100,17031681100,"Census Tract 6811, Cook County, Illinois",3583,3552,14,3537,1,0,0,0,0,0,0,31,15,16,0,0,0,0,0,0,0,0.99609266
1400000US17031681200,17031681200,"Census Tract 6812, Cook County, Illinois",2375,2375,0,2255,57,0,0,47,16,0,16,0,0,0,0,0,0,0,0,0,0,1
1400000US17031681300,17031681300,"Census Tract 6813, Cook County, Illinois",2409,2280,0,2204,29,0,0,0,47,0,47,129,0,21,0,0,12,96,0,0,0,1
1400000US17031681400,17031681400,"Census Tract 6814, Cook County, Illinois",2898,2898,0,2898,0,0,0,0,0,0,0,0,0,0,0,0,0,0,0,0,0,1
1400000US17031690300,17031690300,"Census Tract 6903, Cook County, Illinois",2284,2266,196,2053,7,3,0,0,7,0,7,18,3,15,0,0,0,0,0,0,0,0.914185639
1400000US17031690400,17031690400,"Census Tract 6904, Cook County, Illinois",3581,3450,22,3414,13,0,0,0,1,0,1,131,9,84,0,0,0,29,9,9,0,0.993856465
1400000US17031690500,17031690500,"Census Tract 6905, Cook County, Illinois",952,952,0,947,0,5,0,0,0,0,0,0,0,0,0,0,0,0,0,0,0,1
1400000US17031690900,17031690900,"Census Tract 6909, Cook County, Illinois",4442,4398,57,4341,0,0,0,0,0,0,0,44,0,20,0,0,0,24,0,0,0,0.987167942
1400000US17031691000,17031691000,"Census Tract 6910, Cook County, Illinois",2703,2695,22,2646,0,0,0,0,27,0,27,8,8,0,0,0,0,0,0,0,0,0.991860895
1400000US17031691100,17031691100,"Census Tract 6911, Cook County, Illinois",3209,3153,20,3056,0,0,0,0,77,0,77,56,13,21,0,0,0,13,9,0,9,0.993767529
1400000US17031691200,17031691200,"Census Tract 6912, Cook County, Illinois",2975,2975,81,2754,128,0,0,0,12,0,12,0,0,0,0,0,0,0,0,0,0,0.972773109
1400000US17031691300,17031691300,"Census Tract 6913, Cook County, Illinois",2842,2802,5,2791,0,0,0,0,6,0,6,40,0,18,0,0,0,22,0,0,0,0.998240676
1400000US17031691400,17031691400,"Census Tract 6914, Cook County, Illinois",2716,2697,0,2671,0,12,0,14,0,0,0,19,0,0,0,0,0,19,0,0,0,1
1400000US17031691500,17031691500,"Census Tract 6915, Cook County, Illinois",2124,1981,14,1953,0,0,0,0,14,0,14,143,11,62,0,0,0,23,47,0,47,0.993408663
1400000US17031700100,17031700100,"Census Tract 7001, Cook County, Illinois",3486,2358,272,2083,0,0,0,0,3,0,3,1128,233,32,0,0,0,863,0,0,0,0.921973609
1400000US17031700200,17031700200,"Census Tract 7002, Cook County, Illinois",6868,2039,956,896,0,71,0,0,116,0,116,4829,1651,0,40,0,0,2974,164,143,21,0.860803727
1400000US17031700301,17031700301,"Census Tract 7003.01, Cook County, Illinois",5796,2142,1440,672,0,30,0,0,0,0,0,3654,1582,0,53,0,0,1974,45,45,0,0.751552795
1400000US17031700302,17031700302,"Census Tract 7003.02, Cook County, Illinois",5686,2931,1807,1124,0,0,0,0,0,0,0,2755,1299,44,0,0,0,1294,118,94,24,0.682201899
1400000US17031700401,17031700401,"Census Tract 7004.01, Cook County, Illinois",6261,4252,863,3272,0,6,0,0,111,0,111,2009,925,40,0,0,0,971,73,36,37,0.862162594
1400000US17031700402,17031700402,"Census Tract 7004.02, Cook County, Illinois",3840,3145,343,2701,0,71,0,0,30,0,30,695,283,0,0,0,0,352,60,50,10,0.910677083
1400000US17031700501,17031700501,"Census Tract 7005.01, Cook County, Illinois",7871,7647,441,7048,0,17,0,15,126,106,20,224,159,15,0,0,0,50,0,0,0,0.943971541
1400000US17031700502,17031700502,"Census Tract 7005.02, Cook County, Illinois",3001,2911,110,2788,0,0,0,0,13,0,13,90,0,0,0,0,0,90,0,0,0,0.963345551
1400000US17031710100,17031710100,"Census Tract 7101, Cook County, Illinois",1406,1340,0,1340,0,0,0,0,0,0,0,66,66,0,0,0,0,0,0,0,0,1
1400000US17031710200,17031710200,"Census Tract 7102, Cook County, Illinois",5845,5734,83,5617,0,34,0,0,0,0,0,111,36,0,0,0,0,0,75,0,75,0.985799829
1400000US17031710300,17031710300,"Census Tract 7103, Cook County, Illinois",1365,1355,0,1332,0,0,0,0,23,0,23,10,0,0,4,0,0,0,6,0,6,1
1400000US17031710400,17031710400,"Census Tract 7104, Cook County, Illinois",5092,5038,30,4907,28,0,0,0,73,0,73,54,0,44,0,0,0,0,10,10,0,0.994108405
1400000US17031710500,17031710500,"Census Tract 7105, Cook County, Illinois",4136,4026,37,3815,0,14,0,0,160,0,160,110,9,46,0,0,0,11,44,26,18,0.991054159
1400000US17031710600,17031710600,"Census Tract 7106, Cook County, Illinois",1803,1803,0,1803,0,0,0,0,0,0,0,0,0,0,0,0,0,0,0,0,0,1
1400000US17031710700,17031710700,"Census Tract 7107, Cook County, Illinois",2695,2665,11,2616,0,38,0,0,0,0,0,30,0,0,0,0,0,30,0,0,0,0.995918367
1400000US17031710800,17031710800,"Census Tract 7108, Cook County, Illinois",4917,4837,1,4787,49,0,0,0,0,0,0,80,1,21,0,0,0,0,58,58,0,0.999796624
1400000US17031710900,17031710900,"Census Tract 7109, Cook County, Illinois",2491,2463,4,2448,0,0,0,0,11,0,11,28,4,24,0,0,0,0,0,0,0,0.998394219
1400000US17031711000,17031711000,"Census Tract 7110, Cook County, Illinois",3445,3427,7,3378,0,7,11,0,24,0,24,18,0,18,0,0,0,0,0,0,0,0.99796807
1400000US17031711100,17031711100,"Census Tract 7111, Cook County, Illinois",3136,3136,0,3127,0,9,0,0,0,0,0,0,0,0,0,0,0,0,0,0,0,1
1400000US17031711200,17031711200,"Census Tract 7112, Cook County, Illinois",4928,4928,0,4914,0,14,0,0,0,0,0,0,0,0,0,0,0,0,0,0,0,1
1400000US17031711300,17031711300,"Census Tract 7113, Cook County, Illinois",1580,1538,0,1535,0,3,0,0,0,0,0,42,0,21,0,0,0,21,0,0,0,1
1400000US17031711400,17031711400,"Census Tract 7114, Cook County, Illinois",2249,2168,2,2148,0,7,0,0,11,0,11,81,0,81,0,0,0,0,0,0,0,0.999110716
1400000US17031711500,17031711500,"Census Tract 7115, Cook County, Illinois",2523,2481,0,2437,0,0,0,0,44,0,44,42,0,0,0,0,0,0,42,42,0,1
1400000US17031720100,17031720100,"Census Tract 7201, Cook County, Illinois",3685,3274,1799,1410,0,11,0,20,34,0,34,411,331,14,0,0,0,1,65,59,6,0.511804613
1400000US17031720200,17031720200,"Census Tract 7202, Cook County, Illinois",4344,4100,1496,2496,0,11,0,16,81,0,81,244,219,0,0,0,0,25,0,0,0,0.655616943
1400000US17031720300,17031720300,"Census Tract 7203, Cook County, Illinois",3672,3449,2143,1222,0,33,0,28,23,0,23,223,184,0,0,0,0,39,0,0,0,0.416394336
1400000US17031720400,17031720400,"Census Tract 7204, Cook County, Illinois",1974,1869,1760,67,10,0,0,16,16,0,16,105,51,0,9,0,0,21,24,1,23,0.108409321
1400000US17031720500,17031720500,"Census Tract 7205, Cook County, Illinois",2189,2065,1966,68,0,21,0,0,10,0,10,124,108,0,0,0,0,12,4,4,0,0.101873001
1400000US17031720600,17031720600,"Census Tract 7206, Cook County, Illinois",1709,1687,1450,212,8,7,0,0,10,0,10,22,16,0,0,0,0,6,0,0,0,0.151550614
1400000US17031720700,17031720700,"Census Tract 7207, Cook County, Illinois",3429,3389,1147,2126,0,0,0,2,114,0,114,40,12,28,0,0,0,0,0,0,0,0.665500146
1400000US17031730100,17031730100,"Census Tract 7301, Cook County, Illinois",2548,2525,9,2472,0,0,0,0,44,0,44,23,0,19,0,0,0,0,4,4,0,0.996467818
1400000US17031730201,17031730201,"Census Tract 7302.01, Cook County, Illinois",5824,5699,1,5494,183,1,0,0,20,0,20,125,69,16,0,0,0,40,0,0,0,0.999828297
1400000US17031730202,17031730202,"Census Tract 7302.02, Cook County, Illinois",3479,3379,72,3307,0,0,0,0,0,0,0,100,53,0,0,0,0,0,47,0,47,0.979304398
1400000US17031730300,17031730300,"Census Tract 7303, Cook County, Illinois",983,979,0,961,0,0,0,0,18,0,18,4,4,0,0,0,0,0,0,0,0,1
1400000US17031730400,17031730400,"Census Tract 7304, Cook County, Illinois",3801,3748,6,3662,0,0,0,37,43,0,43,53,5,11,0,0,0,19,18,13,5,0.998421468
1400000US17031730500,17031730500,"Census Tract 7305, Cook County, Illinois",4323,4286,96,4135,0,0,0,29,26,0,26,37,12,25,0,0,0,0,0,0,0,0.977793199
1400000US17031730600,17031730600,"Census Tract 7306, Cook County, Illinois",3218,3218,0,3156,0,0,0,0,62,0,62,0,0,0,0,0,0,0,0,0,0,1
1400000US17031730700,17031730700,"Census Tract 7307, Cook County, Illinois",2259,2242,14,2207,0,0,0,0,21,0,21,17,0,0,0,0,0,17,0,0,0,0.993802568
1400000US17031740100,17031740100,"Census Tract 7401, Cook County, Illinois",2805,2672,2629,0,14,0,0,0,29,0,29,133,120,0,0,0,0,13,0,0,0,0.062745098
1400000US17031740200,17031740200,"Census Tract 7402, Cook County, Illinois",6307,5990,5529,193,0,260,0,0,8,0,8,317,264,0,27,0,0,7,19,19,0,0.123355002
1400000US17031740300,17031740300,"Census Tract 7403, Cook County, Illinois",4436,4060,3934,77,0,30,0,0,19,0,19,376,376,0,0,0,0,0,0,0,0,0.113165014
1400000US17031740400,17031740400,"Census Tract 7404, Cook County, Illinois",4809,4595,3778,556,0,120,0,0,141,0,141,214,65,0,0,0,0,134,15,15,0,0.214389686
1400000US17031750100,17031750100,"Census Tract 7501, Cook County, Illinois",4411,4398,67,4249,0,0,0,0,82,0,82,13,0,13,0,0,0,0,0,0,0,0.984810701
1400000US17031750200,17031750200,"Census Tract 7502, Cook County, Illinois",2875,2866,1229,1484,10,31,0,0,112,0,112,9,0,0,0,0,0,0,9,0,9,0.572521739
1400000US17031750300,17031750300,"Census Tract 7503, Cook County, Illinois",2657,2412,2202,210,0,0,0,0,0,0,0,245,127,0,0,0,0,118,0,0,0,0.171245766
1400000US17031750400,17031750400,"Census Tract 7504, Cook County, Illinois",3187,3110,2010,1056,0,18,0,0,26,0,26,77,35,0,0,0,0,9,33,0,33,0.369312833
1400000US17031750500,17031750500,"Census Tract 7505, Cook County, Illinois",6369,6111,1414,4633,14,3,0,0,47,0,47,258,2,0,0,0,0,5,251,177,74,0.777987125
1400000US17031750600,17031750600,"Census Tract 7506, Cook County, Illinois",3705,3684,3,3499,0,0,0,111,71,12,59,21,0,11,0,0,0,10,0,0,0,0.999190283
1400000US17031760801,17031760801,"Census Tract 7608.01, Cook County, Illinois",4399,4205,3330,73,0,570,0,97,135,0,135,194,34,0,25,0,0,126,9,0,9,0.243009775
1400000US17031760802,17031760802,"Census Tract 7608.02, Cook County, Illinois",2401,2146,2102,16,0,10,0,0,18,0,18,255,238,0,0,0,0,10,7,7,0,0.124531445
1400000US17031760803,17031760803,"Census Tract 7608.03, Cook County, Illinois",7343,6117,4943,61,0,779,0,0,334,0,334,1226,763,0,0,0,0,377,86,20,66,0.32684189
1400000US17031770201,17031770201,"Census Tract 7702.01, Cook County, Illinois",5640,4965,4132,65,0,667,0,0,101,0,101,675,270,0,0,0,0,391,14,14,0,0.267375887
1400000US17031770202,17031770202,"Census Tract 7702.02, Cook County, Illinois",4936,4442,4232,56,71,65,0,18,0,0,0,494,191,0,9,0,0,155,139,110,29,0.142625608
1400000US17031770300,17031770300,"Census Tract 7703, Cook County, Illinois",7282,6560,6150,0,0,395,0,0,15,0,15,722,524,0,0,0,0,186,12,0,12,0.155451799
1400000US17031770400,17031770400,"Census Tract 7704, Cook County, Illinois",4716,3745,3079,37,0,333,0,66,230,75,155,971,242,13,24,0,0,634,58,40,18,0.3471162
1400000US17031770500,17031770500,"Census Tract 7705, Cook County, Illinois",4073,569,481,34,0,0,0,0,54,0,54,3504,1513,0,80,60,0,1753,98,98,0,0.88190523
1400000US17031770601,17031770601,"Census Tract 7706.01, Cook County, Illinois",3163,2553,2181,32,0,340,0,0,0,0,0,610,333,0,0,0,0,264,13,13,0,0.310464749
1400000US17031770602,17031770602,"Census Tract 7706.02, Cook County, Illinois",4733,2616,2226,73,0,291,0,0,26,10,16,2117,858,0,0,0,0,1259,0,0,0,0.529685189
1400000US17031770700,17031770700,"Census Tract 7707, Cook County, Illinois",2590,2290,2033,69,0,175,0,0,13,0,13,300,186,7,0,0,0,107,0,0,0,0.215057915
1400000US17031770800,17031770800,"Census Tract 7708, Cook County, Illinois",5860,4517,3700,97,0,458,0,0,262,0,262,1343,723,0,0,0,0,238,382,232,150,0.368600683
1400000US17031770901,17031770901,"Census Tract 7709.01, Cook County, Illinois",5237,4835,4655,10,0,170,0,0,0,0,0,402,281,0,17,0,0,53,51,51,0,0.111132328
1400000US17031770902,17031770902,"Census Tract 7709.02, Cook County, Illinois",3363,3239,3066,24,0,149,0,0,0,0,0,124,103,0,0,0,0,21,0,0,0,0.088314005
1400000US17031800100,17031800100,"Census Tract 8001, Cook County, Illinois",2593,2563,2446,0,0,96,0,0,21,0,21,30,30,0,0,0,0,0,0,0,0,0.056691091
1400000US17031800200,17031800200,"Census Tract 8002, Cook County, Illinois",6231,6016,5796,64,0,58,0,0,98,16,82,215,198,0,0,0,0,17,0,0,0,0.069812229
1400000US17031800300,17031800300,"Census Tract 8003, Cook County, Illinois",3310,3160,2923,28,0,138,0,0,71,0,71,150,93,0,0,0,0,27,30,30,0,0.116918429
1400000US17031800400,17031800400,"Census Tract 8004, Cook County, Illinois",3716,3661,3202,0,61,237,0,0,161,0,161,55,42,0,0,0,0,0,13,13,0,0.138320775
1400000US17031800500,17031800500,"Census Tract 8005, Cook County, Illinois",5266,5147,4789,1,0,195,0,0,162,0,162,119,70,0,0,0,0,49,0,0,0,0.090581086
1400000US17031800600,17031800600,"Census Tract 8006, Cook County, Illinois",2598,2547,2440,26,0,51,0,0,30,0,30,51,51,0,0,0,0,0,0,0,0,0.060816012
1400000US17031800700,17031800700,"Census Tract 8007, Cook County, Illinois",5050,4751,4376,0,0,375,0,0,0,0,0,299,299,0,0,0,0,0,0,0,0,0.133465347
1400000US17031800800,17031800800,"Census Tract 8008, Cook County, Illinois",2157,2107,1735,0,0,350,0,0,22,22,0,50,19,0,0,0,0,31,0,0,0,0.195642096
1400000US17031800900,17031800900,"Census Tract 8009, Cook County, Illinois",4583,4119,2622,109,0,1361,0,0,27,0,27,464,368,0,0,0,0,48,48,18,30,0.427885664
1400000US17031801000,17031801000,"Census Tract 8010, Cook County, Illinois",4805,4722,3705,8,52,813,0,5,139,0,139,83,40,43,0,0,0,0,0,0,0,0.2289282
1400000US17031801100,17031801100,"Census Tract 8011, Cook County, Illinois",4622,4471,4126,37,0,230,0,0,78,0,78,151,143,0,0,0,0,8,0,0,0,0.107312852
1400000US17031801200,17031801200,"Census Tract 8012, Cook County, Illinois",3454,3319,3111,9,0,146,0,0,53,0,53,135,119,10,0,6,0,0,0,0,0,0.099305153
1400000US17031801300,17031801300,"Census Tract 8013, Cook County, Illinois",4605,4476,4026,94,0,340,6,0,10,0,10,129,81,0,0,0,0,37,11,11,0,0.125732899
1400000US17031801400,17031801400,"Census Tract 8014, Cook County, Illinois",3017,2701,2137,25,0,425,0,0,114,0,114,316,304,0,0,0,0,12,0,0,0,0.291680477
1400000US17031801500,17031801500,"Census Tract 8015, Cook County, Illinois",6735,6493,5588,112,0,637,0,0,156,0,156,242,217,0,0,0,0,25,0,0,0,0.17030438
1400000US17031801601,17031801601,"Census Tract 8016.01, Cook County, Illinois",4342,4283,3572,29,0,671,0,0,11,0,11,59,50,0,0,4,0,5,0,0,0,0.177337632
1400000US17031801603,17031801603,"Census Tract 8016.03, Cook County, Illinois",3872,3709,2009,346,0,1302,0,0,52,0,52,163,109,7,0,0,0,30,17,0,17,0.481146694
1400000US17031801605,17031801605,"Census Tract 8016.05, Cook County, Illinois",5421,5303,4322,109,0,722,0,85,65,0,65,118,68,0,0,0,0,50,0,0,0,0.202730124
1400000US17031801606,17031801606,"Census Tract 8016.06, Cook County, Illinois",5830,5636,4981,1,0,554,0,0,100,0,100,194,160,0,0,0,0,0,34,0,34,0.145626072
1400000US17031801607,17031801607,"Census Tract 8016.07, Cook County, Illinois",5349,5139,3731,113,0,1288,0,0,7,0,7,210,200,0,0,0,0,10,0,0,0,0.302486446
1400000US17031801608,17031801608,"Census Tract 8016.08, Cook County, Illinois",6308,6021,5004,7,0,816,0,30,164,0,164,287,273,0,0,0,0,0,14,0,14,0.206721623
1400000US17031801701,17031801701,"Census Tract 8017.01, Cook County, Illinois",3590,3497,3099,0,0,372,0,0,26,0,26,93,84,0,0,0,0,0,9,0,9,0.136768802
1400000US17031801702,17031801702,"Census Tract 8017.02, Cook County, Illinois",4893,4764,4087,0,0,519,0,0,158,17,141,129,97,0,0,0,0,32,0,0,0,0.164725118
1400000US17031801800,17031801800,"Census Tract 8018, Cook County, Illinois",5444,5405,4986,0,0,379,0,0,40,0,40,39,39,0,0,0,0,0,0,0,0,0.084129317
1400000US17031801901,17031801901,"Census Tract 8019.01, Cook County, Illinois",4342,3620,3049,133,12,418,0,0,8,0,8,722,480,0,0,0,0,200,42,42,0,0.297789037
1400000US17031801902,17031801902,"Census Tract 8019.02, Cook County, Illinois",3334,3180,2845,38,0,193,0,6,98,0,98,154,154,0,0,0,0,0,0,0,0,0.146670666
1400000US17031802002,17031802002,"Census Tract 8020.02, Cook County, Illinois",5475,5194,4330,69,0,666,0,29,100,0,100,281,227,0,0,0,0,54,0,0,0,0.20913242
1400000US17031802003,17031802003,"Census Tract 8020.03, Cook County, Illinois",2785,2213,1640,70,0,503,0,0,0,0,0,572,561,0,0,0,0,11,0,0,0,0.411131059
1400000US17031802004,17031802004,"Census Tract 8020.04, Cook County, Illinois",5554,4600,2801,63,73,1600,0,20,43,0,43,954,825,0,0,0,0,129,0,0,0,0.49567879
1400000US17031802100,17031802100,"Census Tract 8021, Cook County, Illinois",3335,3276,3021,2,0,104,0,0,149,6,143,59,59,0,0,0,0,0,0,0,0,0.094152924
1400000US17031802200,17031802200,"Census Tract 8022, Cook County, Illinois",4182,3979,3730,31,0,174,0,19,25,0,25,203,203,0,0,0,0,0,0,0,0,0.108082257
1400000US17031802300,17031802300,"Census Tract 8023, Cook County, Illinois",5174,4881,3954,91,0,685,0,0,151,0,151,293,191,0,0,0,0,13,89,89,0,0.235794356
1400000US17031802402,17031802402,"Census Tract 8024.02, Cook County, Illinois",5453,3300,2684,67,0,524,25,0,0,0,0,2153,1699,0,0,0,0,444,10,10,0,0.507793875
1400000US17031802403,17031802403,"Census Tract 8024.03, Cook County, Illinois",1457,1404,1138,12,0,224,0,0,30,0,30,53,39,0,0,0,0,0,14,0,14,0.218943034
1400000US17031802404,17031802404,"Census Tract 8024.04, Cook County, Illinois",7385,4689,3503,72,0,1067,0,0,47,0,47,2696,1475,0,52,0,0,1149,20,20,0,0.525660122
1400000US17031802503,17031802503,"Census Tract 8025.03, Cook County, Illinois",5512,4933,3782,14,20,1117,0,0,0,0,0,579,39,0,0,0,0,525,15,15,0,0.313860668
1400000US17031802504,17031802504,"Census Tract 8025.04, Cook County, Illinois",6676,4096,3119,41,0,862,0,6,68,37,31,2580,1418,0,0,0,0,1130,32,16,16,0.532804074
1400000US17031802505,17031802505,"Census Tract 8025.05, Cook County, Illinois",6888,3346,2151,219,41,913,0,0,22,0,22,3542,1559,0,0,0,0,1983,0,0,0,0.68771777
1400000US17031802506,17031802506,"Census Tract 8025.06, Cook County, Illinois",2904,1179,998,6,0,166,0,0,9,0,9,1725,865,0,33,0,0,715,112,112,0,0.656336088
1400000US17031802605,17031802605,"Census Tract 8026.05, Cook County, Illinois",7204,6624,5149,331,0,1054,0,0,90,25,65,580,496,0,0,0,0,1,83,83,0,0.28525819
1400000US17031802607,17031802607,"Census Tract 8026.07, Cook County, Illinois",1329,1298,1209,0,0,89,0,0,0,0,0,31,31,0,0,0,0,0,0,0,0,0.090293454
1400000US17031802608,17031802608,"Census Tract 8026.08, Cook County, Illinois",6465,6203,5843,20,0,304,36,0,0,0,0,262,247,0,0,0,0,15,0,0,0,0.096210363
1400000US17031802609,17031802609,"Census Tract 8026.09, Cook County, Illinois",6477,3360,2391,0,3,946,20,0,0,0,0,3117,1983,44,0,0,0,996,94,94,0,0.630847615
1400000US17031802610,17031802610,"Census Tract 8026.10, Cook County, Illinois",1614,1525,1103,0,30,262,0,0,130,37,93,89,11,0,0,0,0,78,0,0,0,0.316604709
1400000US17031802701,17031802701,"Census Tract 8027.01, Cook County, Illinois",6715,5163,4064,31,61,983,0,0,24,0,24,1552,711,0,0,0,0,841,0,0,0,0.394787789
1400000US17031802702,17031802702,"Census Tract 8027.02, Cook County, Illinois",4718,4372,3217,122,0,958,0,0,75,13,62,346,112,8,12,14,0,175,25,25,0,0.318143281
1400000US17031802801,17031802801,"Census Tract 8028.01, Cook County, Illinois",5105,4770,4055,87,0,570,0,0,58,0,58,335,335,0,0,0,0,0,0,0,0,0.205680705
1400000US17031802802,17031802802,"Census Tract 8028.02, Cook County, Illinois",6468,6072,5499,35,0,501,0,12,25,0,25,396,316,0,0,0,0,80,0,0,0,0.149814471
1400000US17031802900,17031802900,"Census Tract 8029, Cook County, Illinois",6052,6006,5655,14,0,276,0,0,61,0,61,46,12,0,0,0,0,34,0,0,0,0.065598149
1400000US17031803005,17031803005,"Census Tract 8030.05, Cook County, Illinois",2744,2721,2438,102,0,113,0,0,68,0,68,23,23,0,0,0,0,0,0,0,0,0.111516035
1400000US17031803007,17031803007,"Census Tract 8030.07, Cook County, Illinois",4802,4500,4126,2,0,224,0,52,96,0,96,302,127,0,0,60,0,115,0,0,0,0.140774677
1400000US17031803008,17031803008,"Census Tract 8030.08, Cook County, Illinois",4542,4167,3674,64,0,349,0,0,80,0,80,375,201,23,0,0,0,72,79,69,10,0.19110524
1400000US17031803010,17031803010,"Census Tract 8030.10, Cook County, Illinois",4698,4262,3769,0,8,373,0,0,112,0,112,436,330,0,0,0,0,106,0,0,0,0.197743721
1400000US17031803012,17031803012,"Census Tract 8030.12, Cook County, Illinois",2319,2076,1773,103,0,190,0,0,10,0,10,243,154,0,0,0,0,75,14,0,14,0.235446313
1400000US17031803013,17031803013,"Census Tract 8030.13, Cook County, Illinois",5269,5108,4570,86,0,416,0,7,29,0,29,161,89,0,0,0,0,30,42,0,42,0.132662744
1400000US17031803014,17031803014,"Census Tract 8030.14, Cook County, Illinois",3296,2722,2269,20,0,420,0,0,13,13,0,574,304,0,0,0,0,270,0,0,0,0.311589806
1400000US17031803015,17031803015,"Census Tract 8030.15, Cook County, Illinois",4535,4186,3684,95,14,286,0,0,107,0,107,349,261,0,0,0,0,88,0,0,0,0.187651599
1400000US17031803016,17031803016,"Census Tract 8030.16, Cook County, Illinois",2361,2216,1426,51,0,715,0,0,24,0,24,145,58,0,0,0,0,50,37,0,37,0.396018636
1400000US17031803017,17031803017,"Census Tract 8030.17, Cook County, Illinois",5504,5188,4416,19,0,673,0,0,80,0,80,316,151,0,0,8,0,157,0,0,0,0.197674419
1400000US17031803100,17031803100,"Census Tract 8031, Cook County, Illinois",3331,3259,3108,82,0,69,0,0,0,0,0,72,59,0,0,0,0,0,13,0,13,0.066946863
1400000US17031803200,17031803200,"Census Tract 8032, Cook County, Illinois",5898,5340,5123,66,0,93,0,0,58,0,58,558,402,0,0,0,0,114,42,42,0,0.131400475
1400000US17031803300,17031803300,"Census Tract 8033, Cook County, Illinois",5729,5456,4831,8,0,533,0,26,58,0,58,273,123,0,0,0,0,150,0,0,0,0.156746378
1400000US17031803400,17031803400,"Census Tract 8034, Cook County, Illinois",6197,5700,5426,46,0,157,0,0,71,0,71,497,357,0,22,0,0,84,34,12,22,0.12441504
1400000US17031803500,17031803500,"Census Tract 8035, Cook County, Illinois",6327,6179,5994,6,0,67,0,0,112,0,112,148,89,0,0,0,0,0,59,0,59,0.052631579
1400000US17031803603,17031803603,"Census Tract 8036.03, Cook County, Illinois",6725,6588,5269,43,0,1120,0,0,156,0,156,137,104,33,0,0,0,0,0,0,0,0.216505576
1400000US17031803604,17031803604,"Census Tract 8036.04, Cook County, Illinois",4450,4261,3578,147,0,485,0,0,51,0,51,189,180,0,0,0,0,9,0,0,0,0.195955056
1400000US17031803605,17031803605,"Census Tract 8036.05, Cook County, Illinois",7462,6205,5071,189,0,862,0,31,52,19,33,1257,515,0,0,0,0,347,395,292,103,0.320423479
1400000US17031803606,17031803606,"Census Tract 8036.06, Cook County, Illinois",9166,3832,1913,561,0,1186,0,0,172,31,141,5334,2897,0,0,0,0,2365,72,72,0,0.791293912
1400000US17031803607,17031803607,"Census Tract 8036.07, Cook County, Illinois",5046,4843,4184,58,0,576,0,0,25,0,25,203,153,0,0,0,0,50,0,0,0,0.170828379
1400000US17031803608,17031803608,"Census Tract 8036.08, Cook County, Illinois",7773,6771,4997,336,0,1373,0,0,65,0,65,1002,569,172,0,0,0,216,45,18,27,0.357133668
1400000US17031803610,17031803610,"Census Tract 8036.10, Cook County, Illinois",7491,6699,4769,267,16,1520,0,42,85,0,85,792,428,61,32,0,0,193,78,78,0,0.363369377
1400000US17031803611,17031803611,"Census Tract 8036.11, Cook County, Illinois",5881,3351,2387,273,0,676,0,0,15,0,15,2530,935,22,0,0,0,1560,13,13,0,0.594116647
1400000US17031803612,17031803612,"Census Tract 8036.12, Cook County, Illinois",3606,1908,1274,203,10,421,0,0,0,0,0,1698,642,0,13,0,0,1043,0,0,0,0.646699945
1400000US17031803701,17031803701,"Census Tract 8037.01, Cook County, Illinois",2658,2476,2068,15,0,319,0,0,74,0,74,182,112,0,0,23,0,47,0,0,0,0.221971407
1400000US17031803702,17031803702,"Census Tract 8037.02, Cook County, Illinois",5952,5487,4369,14,0,889,0,0,215,0,215,465,247,0,0,0,0,218,0,0,0,0.265961022
1400000US17031803800,17031803800,"Census Tract 8038, Cook County, Illinois",5000,4300,3864,3,0,342,0,0,91,8,83,700,521,0,0,0,0,135,44,27,17,0.2272
1400000US17031803901,17031803901,"Census Tract 8039.01, Cook County, Illinois",3363,2964,2506,90,0,368,0,0,0,0,0,399,304,0,80,0,0,15,0,0,0,0.254831995
1400000US17031803902,17031803902,"Census Tract 8039.02, Cook County, Illinois",3710,3152,3030,67,0,47,0,0,8,0,8,558,558,0,0,0,0,0,0,0,0,0.18328841
1400000US17031804000,17031804000,"Census Tract 8040, Cook County, Illinois",4487,3916,3606,41,0,213,0,0,56,0,56,571,262,0,0,0,0,309,0,0,0,0.196344997
1400000US17031804102,17031804102,"Census Tract 8041.02, Cook County, Illinois",6621,6396,5382,21,0,878,38,0,77,0,77,225,225,0,0,0,0,0,0,0,0,0.187131853
1400000US17031804104,17031804104,"Census Tract 8041.04, Cook County, Illinois",5079,4801,3302,28,0,1384,0,0,87,0,87,278,276,0,0,0,0,2,0,0,0,0.349872022
1400000US17031804105,17031804105,"Census Tract 8041.05, Cook County, Illinois",4320,4077,3332,57,0,542,0,0,146,10,136,243,243,0,0,0,0,0,0,0,0,0.228703704
1400000US17031804106,17031804106,"Census Tract 8041.06, Cook County, Illinois",7009,6623,4908,125,0,1477,0,0,113,34,79,386,192,0,14,0,0,180,0,0,0,0.299757455
1400000US17031804108,17031804108,"Census Tract 8041.08, Cook County, Illinois",3815,3443,1386,339,0,1646,13,0,59,41,18,372,216,0,0,0,0,151,5,0,5,0.636697248
1400000US17031804109,17031804109,"Census Tract 8041.09, Cook County, Illinois",2992,2734,2319,181,0,164,0,0,70,0,70,258,91,0,0,0,0,124,43,43,0,0.224933155
1400000US17031804201,17031804201,"Census Tract 8042.01, Cook County, Illinois",7989,7719,5657,85,0,1805,0,0,172,91,81,270,153,0,14,81,0,0,22,0,22,0.291901364
1400000US17031804202,17031804202,"Census Tract 8042.02, Cook County, Illinois",7838,7324,6069,0,0,1140,0,0,115,53,62,514,489,0,0,0,0,25,0,0,0,0.22569533
1400000US17031804305,17031804305,"Census Tract 8043.05, Cook County, Illinois",7962,4605,3915,224,0,304,0,0,162,0,162,3357,810,35,79,0,8,2352,73,0,73,0.508289375
1400000US17031804306,17031804306,"Census Tract 8043.06, Cook County, Illinois",6138,3342,3126,71,0,21,0,0,124,53,71,2796,742,0,0,0,0,1976,78,63,15,0.490713587
1400000US17031804308,17031804308,"Census Tract 8043.08, Cook County, Illinois",5157,4648,3236,55,0,1205,0,0,152,0,152,509,135,33,0,18,0,291,32,32,0,0.372503393
1400000US17031804309,17031804309,"Census Tract 8043.09, Cook County, Illinois",2957,1893,1267,43,0,577,0,0,6,0,6,1064,343,0,0,0,0,674,47,47,0,0.571525194
1400000US17031804310,17031804310,"Census Tract 8043.10, Cook County, Illinois",9358,7591,5131,216,0,2244,0,0,0,0,0,1767,550,0,0,0,0,1103,114,99,15,0.451699081
1400000US17031804311,17031804311,"Census Tract 8043.11, Cook County, Illinois",8507,5719,3105,31,0,2315,0,16,252,0,252,2788,1245,0,74,0,0,1461,8,8,0,0.635006465
1400000US17031804403,17031804403,"Census Tract 8044.03, Cook County, Illinois",6834,4018,2788,206,0,966,0,10,48,0,48,2816,2056,200,103,46,0,309,102,0,102,0.592039801
1400000US17031804404,17031804404,"Census Tract 8044.04, Cook County, Illinois",5326,2250,1439,205,0,601,0,0,5,0,5,3076,1671,0,0,0,0,1313,92,59,33,0.729815997
1400000US17031804405,17031804405,"Census Tract 8044.05, Cook County, Illinois",3376,1136,593,363,0,136,0,0,44,0,44,2240,479,0,0,0,0,1734,27,27,0,0.824348341
1400000US17031804406,17031804406,"Census Tract 8044.06, Cook County, Illinois",6194,3170,2161,187,0,795,0,13,14,0,14,3024,864,0,49,0,0,1935,176,111,65,0.651113981
1400000US17031804505,17031804505,"Census Tract 8045.05, Cook County, Illinois",3652,2906,2564,92,17,167,0,0,66,0,66,746,300,0,0,14,0,432,0,0,0,0.297918949
1400000US17031804506,17031804506,"Census Tract 8045.06, Cook County, Illinois",4988,4510,3615,141,13,587,0,0,154,16,138,478,215,0,0,0,0,263,0,0,0,0.275260626
1400000US17031804507,17031804507,"Census Tract 8045.07, Cook County, Illinois",12552,11439,7499,375,0,3544,0,0,21,0,21,1113,703,0,43,0,0,207,160,0,160,0.402565328
1400000US17031804508,17031804508,"Census Tract 8045.08, Cook County, Illinois",2469,1384,747,256,0,374,0,0,7,0,7,1085,342,0,10,0,0,733,0,0,0,0.69744836
1400000US17031804509,17031804509,"Census Tract 8045.09, Cook County, Illinois",5594,2675,1977,110,0,409,0,0,179,30,149,2919,870,0,0,0,0,2033,16,0,16,0.646585627
1400000US17031804510,17031804510,"Census Tract 8045.10, Cook County, Illinois",6713,1899,1479,286,0,58,0,33,43,0,43,4814,1000,0,0,0,0,3814,0,0,0,0.779681216
1400000US17031804511,17031804511,"Census Tract 8045.11, Cook County, Illinois",2643,969,481,53,0,426,0,9,0,0,0,1674,340,0,20,0,0,1295,19,19,0,0.818009837
1400000US17031804603,17031804603,"Census Tract 8046.03, Cook County, Illinois",5285,3980,2905,170,0,807,0,0,98,0,98,1305,262,0,40,0,0,958,45,29,16,0.450331126
1400000US17031804606,17031804606,"Census Tract 8046.06, Cook County, Illinois",7363,7045,5468,42,0,1429,0,0,106,34,72,318,300,0,0,0,18,0,0,0,0,0.257367921
1400000US17031804607,17031804607,"Census Tract 8046.07, Cook County, Illinois",6870,6645,5280,148,0,1165,0,0,52,0,52,225,173,0,0,0,0,52,0,0,0,0.231441048
1400000US17031804608,17031804608,"Census Tract 8046.08, Cook County, Illinois",3612,3324,2238,108,0,903,0,0,75,0,75,288,283,0,0,0,0,5,0,0,0,0.380398671
1400000US17031804609,17031804609,"Census Tract 8046.09, Cook County, Illinois",5739,5358,3843,22,0,1405,0,0,88,0,88,381,260,0,0,0,0,121,0,0,0,0.330371145
1400000US17031804610,17031804610,"Census Tract 8046.10, Cook County, Illinois",2348,2212,1752,0,0,327,0,133,0,0,0,136,114,0,0,0,0,0,22,0,22,0.253833049
1400000US17031804611,17031804611,"Census Tract 8046.11, Cook County, Illinois",4437,4310,3315,85,0,759,0,0,151,36,115,127,87,0,0,0,0,40,0,0,0,0.252873563
1400000US17031804701,17031804701,"Census Tract 8047.01, Cook County, Illinois",6794,4852,1872,1062,0,1705,0,0,213,81,132,1942,517,0,0,11,0,1414,0,0,0,0.724462761
1400000US17031804705,17031804705,"Census Tract 8047.05, Cook County, Illinois",3937,3307,1998,250,0,1010,0,6,43,26,17,630,201,0,0,0,0,286,143,119,24,0.492506985
1400000US17031804706,17031804706,"Census Tract 8047.06, Cook County, Illinois",2506,2381,1988,0,7,351,0,0,35,0,35,125,97,0,0,0,0,4,24,13,11,0.206703911
1400000US17031804709,17031804709,"Census Tract 8047.09, Cook County, Illinois",6100,5081,3330,522,16,1174,0,0,39,28,11,1019,61,0,0,0,0,958,0,0,0,0.454098361
1400000US17031804710,17031804710,"Census Tract 8047.10, Cook County, Illinois",4393,3748,3223,0,0,475,0,0,50,14,36,645,453,0,0,0,0,192,0,0,0,0.266332802
1400000US17031804711,17031804711,"Census Tract 8047.11, Cook County, Illinois",8091,6493,3181,632,0,2588,0,0,92,28,64,1598,735,0,0,87,0,776,0,0,0,0.606847114
1400000US17031804712,17031804712,"Census Tract 8047.12, Cook County, Illinois",5609,4752,3623,124,11,864,0,11,119,0,119,857,199,0,0,11,0,634,13,0,13,0.35407381
1400000US17031804713,17031804713,"Census Tract 8047.13, Cook County, Illinois",4313,4219,2441,159,0,1474,0,118,27,0,27,94,85,0,0,0,0,9,0,0,0,0.434036633
1400000US17031804714,17031804714,"Census Tract 8047.14, Cook County, Illinois",3413,2969,2476,82,0,359,0,0,52,0,52,444,222,0,0,0,0,148,74,53,21,0.274538529
1400000US17031804715,17031804715,"Census Tract 8047.15, Cook County, Illinois",3375,1876,785,165,0,824,0,0,102,0,102,1499,517,10,21,0,0,924,27,18,9,0.767407407
1400000US17031804716,17031804716,"Census Tract 8047.16, Cook County, Illinois",5686,4295,2316,87,0,1835,0,51,6,0,6,1391,632,12,0,0,0,747,0,0,0,0.592683785
1400000US17031804803,17031804803,"Census Tract 8048.03, Cook County, Illinois",5805,5559,4242,225,0,1026,0,0,66,0,66,246,246,0,0,0,0,0,0,0,0,0.269250646
1400000US17031804804,17031804804,"Census Tract 8048.04, Cook County, Illinois",6897,5692,3679,282,0,1511,0,0,220,48,172,1205,533,0,0,26,0,597,49,0,49,0.466579672
1400000US17031804805,17031804805,"Census Tract 8048.05, Cook County, Illinois",7043,6124,4592,613,0,810,0,0,109,0,109,919,675,0,0,0,0,244,0,0,0,0.348005111
1400000US17031804806,17031804806,"Census Tract 8048.06, Cook County, Illinois",3891,2826,1866,419,0,541,0,0,0,0,0,1065,420,0,0,0,0,645,0,0,0,0.520431766
1400000US17031804807,17031804807,"Census Tract 8048.07, Cook County, Illinois",5003,4383,3473,365,0,487,0,0,58,0,58,620,381,0,13,0,0,141,85,0,85,0.30581651
1400000US17031804808,17031804808,"Census Tract 8048.08, Cook County, Illinois",2555,2252,2058,9,8,163,0,0,14,0,14,303,303,0,0,0,0,0,0,0,0,0.194520548
1400000US17031804809,17031804809,"Census Tract 8048.09, Cook County, Illinois",4188,4116,3489,48,0,510,0,0,69,0,69,72,72,0,0,0,0,0,0,0,0,0.166905444
1400000US17031804810,17031804810,"Census Tract 8048.10, Cook County, Illinois",7017,6054,4646,334,0,970,0,0,104,0,104,963,488,0,0,0,0,402,73,30,43,0.337893687
1400000US17031804901,17031804901,"Census Tract 8049.01, Cook County, Illinois",6334,6109,5640,57,0,311,0,0,101,0,101,225,200,0,0,0,0,25,0,0,0,0.109567414
1400000US17031804902,17031804902,"Census Tract 8049.02, Cook County, Illinois",5753,4934,3969,1,14,804,0,0,146,28,118,819,357,0,0,0,0,462,0,0,0,0.310099079
1400000US17031805001,17031805001,"Census Tract 8050.01, Cook County, Illinois",4856,4496,4282,24,0,115,0,0,75,0,75,360,360,0,0,0,0,0,0,0,0,0.118204283
1400000US17031805002,17031805002,"Census Tract 8050.02, Cook County, Illinois",6647,5921,4294,297,0,1254,0,0,76,0,76,726,19,17,16,0,0,674,0,0,0,0.353994283
1400000US17031805105,17031805105,"Census Tract 8051.05, Cook County, Illinois",7268,4112,2977,407,0,659,69,0,0,0,0,3156,1100,0,0,0,0,2056,0,0,0,0.590396258
1400000US17031805106,17031805106,"Census Tract 8051.06, Cook County, Illinois",2668,2605,2343,108,0,116,0,0,38,0,38,63,63,0,0,0,0,0,0,0,0,0.121814093
1400000US17031805107,17031805107,"Census Tract 8051.07, Cook County, Illinois",6953,4941,3295,277,39,1037,0,0,293,12,281,2012,494,48,140,0,0,1241,89,89,0,0.52610384
1400000US17031805108,17031805108,"Census Tract 8051.08, Cook County, Illinois",7144,4196,2561,337,0,1236,0,13,49,0,49,2948,564,0,40,0,0,2326,18,0,18,0.641517357
1400000US17031805109,17031805109,"Census Tract 8051.09, Cook County, Illinois",4322,4234,3808,42,0,376,0,0,8,0,8,88,88,0,0,0,0,0,0,0,0,0.118926423
1400000US17031805110,17031805110,"Census Tract 8051.10, Cook County, Illinois",4214,4083,3465,88,0,486,0,11,33,0,33,131,123,0,0,0,0,8,0,0,0,0.177740864
1400000US17031805111,17031805111,"Census Tract 8051.11, Cook County, Illinois",7548,5173,3448,246,31,1338,11,44,55,0,55,2375,810,0,0,0,0,1565,0,0,0,0.543190249
1400000US17031805112,17031805112,"Census Tract 8051.12, Cook County, Illinois",2947,2662,1775,10,0,775,0,0,102,35,67,285,165,0,0,0,0,111,9,9,0,0.397692569
1400000US17031805201,17031805201,"Census Tract 8052.01, Cook County, Illinois",3315,3121,2307,25,0,684,0,0,105,0,105,194,181,0,8,0,0,5,0,0,0,0.304072398
1400000US17031805202,17031805202,"Census Tract 8052.02, Cook County, Illinois",4025,3643,2636,118,0,880,0,0,9,9,0,382,267,0,11,0,0,68,36,0,36,0.345093168
1400000US17031805301,17031805301,"Census Tract 8053.01, Cook County, Illinois",3236,2974,1919,28,0,935,0,0,92,0,92,262,212,0,0,27,0,23,0,0,0,0.406983931
1400000US17031805302,17031805302,"Census Tract 8053.02, Cook County, Illinois",3519,3401,2403,52,0,901,0,20,25,0,25,118,118,0,0,0,0,0,0,0,0,0.31713555
1400000US17031805401,17031805401,"Census Tract 8054.01, Cook County, Illinois",3847,3510,3019,146,0,330,0,0,15,0,15,337,296,0,0,9,0,32,0,0,0,0.215232649
1400000US17031805402,17031805402,"Census Tract 8054.02, Cook County, Illinois",4790,4227,3461,41,72,605,0,0,48,20,28,563,251,0,0,0,0,302,10,10,0,0.277453027
1400000US17031805501,17031805501,"Census Tract 8055.01, Cook County, Illinois",3759,3548,3198,13,0,284,0,0,53,0,53,211,211,0,0,0,0,0,0,0,0,0.14924182
1400000US17031805502,17031805502,"Census Tract 8055.02, Cook County, Illinois",3947,3697,3654,13,0,25,0,0,5,0,5,250,237,0,0,0,0,13,0,0,0,0.074233595
1400000US17031805600,17031805600,"Census Tract 8056, Cook County, Illinois",4679,4527,4431,26,0,59,0,0,11,0,11,152,147,0,0,0,0,5,0,0,0,0.053002778
1400000US17031805701,17031805701,"Census Tract 8057.01, Cook County, Illinois",5151,4676,4425,0,0,163,0,0,88,0,88,475,373,0,0,0,0,76,26,0,26,0.140943506
1400000US17031805702,17031805702,"Census Tract 8057.02, Cook County, Illinois",1899,1833,1702,2,10,94,0,0,25,0,25,66,65,0,0,0,0,0,1,1,0,0.10373881
1400000US17031805801,17031805801,"Census Tract 8058.01, Cook County, Illinois",2385,2365,2086,32,0,177,0,0,70,10,60,20,20,0,0,0,0,0,0,0,0,0.125366876
1400000US17031805802,17031805802,"Census Tract 8058.02, Cook County, Illinois",4939,4536,4376,20,0,98,0,0,42,0,42,403,342,0,0,11,0,50,0,0,0,0.113990686
1400000US17031805901,17031805901,"Census Tract 8059.01, Cook County, Illinois",4068,3732,3458,7,0,225,0,0,42,0,42,336,201,0,0,0,0,135,0,0,0,0.149950836
1400000US17031805902,17031805902,"Census Tract 8059.02, Cook County, Illinois",6448,6068,4708,227,6,1125,0,0,2,0,2,380,278,0,0,0,0,68,34,34,0,0.269851117
1400000US17031806001,17031806001,"Census Tract 8060.01, Cook County, Illinois",6263,5397,3067,241,45,1932,0,0,112,32,80,866,502,0,0,26,0,338,0,0,0,0.510298579
1400000US17031806002,17031806002,"Census Tract 8060.02, Cook County, Illinois",7762,6730,3326,443,0,2847,0,0,114,28,86,1032,566,0,0,18,0,448,0,0,0,0.57150219
1400000US17031806003,17031806003,"Census Tract 8060.03, Cook County, Illinois",7652,6602,3432,125,0,3045,0,0,0,0,0,1050,959,0,0,0,0,91,0,0,0,0.551489807
1400000US17031806004,17031806004,"Census Tract 8060.04, Cook County, Illinois",7671,6186,4307,153,0,1500,0,0,226,17,209,1485,1150,114,0,0,0,206,15,15,0,0.438534741
1400000US17031806102,17031806102,"Census Tract 8061.02, Cook County, Illinois",4140,3552,2790,213,17,532,0,0,0,0,0,588,408,9,0,0,0,171,0,0,0,0.326086957
1400000US17031806103,17031806103,"Census Tract 8061.03, Cook County, Illinois",5308,4953,3926,164,25,764,0,0,74,0,74,355,94,0,22,0,0,224,15,8,7,0.260361718
1400000US17031806104,17031806104,"Census Tract 8061.04, Cook County, Illinois",4941,4190,2350,699,0,1090,0,0,51,0,51,751,177,0,11,0,0,547,16,0,16,0.524387776
1400000US17031806201,17031806201,"Census Tract 8062.01, Cook County, Illinois",4549,3745,3059,52,0,606,12,0,16,0,16,804,422,0,0,0,0,382,0,0,0,0.327544515
1400000US17031806202,17031806202,"Census Tract 8062.02, Cook County, Illinois",4434,4052,3689,72,0,291,0,0,0,0,0,382,178,0,0,0,0,73,131,131,0,0.168019847
1400000US17031806300,17031806300,"Census Tract 8063, Cook County, Illinois",4843,3980,3532,0,0,330,0,0,118,0,118,863,414,0,10,0,0,439,0,0,0,0.270699979
1400000US17031806400,17031806400,"Census Tract 8064, Cook County, Illinois",2459,1959,1842,17,0,81,0,0,19,7,12,500,334,0,0,0,0,166,0,0,0,0.250915006
1400000US17031806501,17031806501,"Census Tract 8065.01, Cook County, Illinois",2519,1516,778,7,0,705,0,0,26,15,11,1003,588,0,0,0,0,402,13,9,4,0.691147281
1400000US17031806502,17031806502,"Census Tract 8065.02, Cook County, Illinois",4372,2716,2222,92,0,348,0,0,54,13,41,1656,1344,0,0,10,0,282,20,0,20,0.491765782
1400000US17031806600,17031806600,"Census Tract 8066, Cook County, Illinois",3436,2430,1877,99,0,364,0,10,80,0,80,1006,563,0,14,0,0,429,0,0,0,0.453725262
1400000US17031806700,17031806700,"Census Tract 8067, Cook County, Illinois",4217,3898,3021,229,17,491,0,0,140,0,140,319,170,0,0,0,0,127,22,22,0,0.283613944
1400000US17031806801,17031806801,"Census Tract 8068.01, Cook County, Illinois",3878,3560,2179,557,3,639,0,49,133,0,133,318,281,0,0,0,0,5,32,32,0,0.438112429
1400000US17031806802,17031806802,"Census Tract 8068.02, Cook County, Illinois",2965,2719,1580,232,0,865,0,0,42,0,42,246,237,0,0,0,0,9,0,0,0,0.467116358
1400000US17031806900,17031806900,"Census Tract 8069, Cook County, Illinois",4685,4376,2245,12,0,2016,0,9,94,0,94,309,255,0,0,36,0,18,0,0,0,0.520811099
1400000US17031807000,17031807000,"Census Tract 8070, Cook County, Illinois",5924,5527,3313,692,0,1465,0,0,57,0,57,397,305,0,0,13,0,79,0,0,0,0.440749494
1400000US17031807100,17031807100,"Census Tract 8071, Cook County, Illinois",3652,3490,2706,468,0,234,0,0,82,16,66,162,141,0,0,0,0,21,0,0,0,0.259036145
1400000US17031807200,17031807200,"Census Tract 8072, Cook County, Illinois",5836,5013,2834,504,0,1487,0,29,159,0,159,823,614,30,0,0,0,179,0,0,0,0.51439342
1400000US17031807300,17031807300,"Census Tract 8073, Cook County, Illinois",7425,6919,3803,366,17,2577,0,0,156,0,156,506,437,0,0,0,0,38,31,14,17,0.487811448
1400000US17031807400,17031807400,"Census Tract 8074, Cook County, Illinois",6836,5760,3783,407,2,1440,0,32,96,0,96,1076,985,0,14,0,0,41,36,36,0,0.446606202
1400000US17031807500,17031807500,"Census Tract 8075, Cook County, Illinois",3437,3023,1808,152,0,959,0,18,86,0,86,414,268,0,0,15,0,131,0,0,0,0.473959849
1400000US17031807600,17031807600,"Census Tract 8076, Cook County, Illinois",6366,5635,2801,78,0,2532,0,38,186,0,186,731,624,0,0,10,0,1,96,96,0,0.560006283
1400000US17031807700,17031807700,"Census Tract 8077, Cook County, Illinois",6239,5150,2906,341,0,1668,0,0,235,0,235,1089,897,0,0,0,0,192,0,0,0,0.534220228
1400000US17031807800,17031807800,"Census Tract 8078, Cook County, Illinois",2755,2369,1741,17,0,587,0,0,24,3,21,386,332,0,0,0,0,45,9,9,0,0.368058076
1400000US17031807900,17031807900,"Census Tract 8079, Cook County, Illinois",4074,3564,2468,0,0,1051,0,0,45,0,45,510,325,0,0,0,0,67,118,5,113,0.394207167
1400000US17031808001,17031808001,"Census Tract 8080.01, Cook County, Illinois",3891,3619,2395,171,0,970,0,0,83,0,83,272,241,0,0,0,0,0,31,31,0,0.384476998
1400000US17031808002,17031808002,"Census Tract 8080.02, Cook County, Illinois",4688,4538,2733,157,0,1603,0,0,45,0,45,150,53,0,0,0,0,89,8,8,0,0.417022184
1400000US17031808100,17031808100,"Census Tract 8081, Cook County, Illinois",3552,3199,2669,187,0,330,0,0,13,0,13,353,290,0,0,0,0,55,8,8,0,0.248592342
1400000US17031808200,17031808200,"Census Tract 8082, Cook County, Illinois",5600,5270,3798,1,83,1335,0,0,53,0,53,330,285,0,0,0,0,45,0,0,0,0.321785714
1400000US17031808301,17031808301,"Census Tract 8083.01, Cook County, Illinois",5923,5597,3448,98,0,1792,0,170,89,14,75,326,247,0,51,15,0,13,0,0,0,0.41786257
1400000US17031808302,17031808302,"Census Tract 8083.02, Cook County, Illinois",3947,3689,2167,194,0,1241,0,14,73,0,73,258,210,0,0,0,0,48,0,0,0,0.450975424
1400000US17031808400,17031808400,"Census Tract 8084, Cook County, Illinois",4387,3992,2320,50,9,1293,0,8,312,0,312,395,191,0,0,24,0,158,22,0,22,0.471164805
1400000US17031808500,17031808500,"Census Tract 8085, Cook County, Illinois",4072,3888,2570,70,0,1095,0,0,153,76,77,184,112,0,0,21,0,38,13,0,13,0.368860511
1400000US17031808600,17031808600,"Census Tract 8086, Cook County, Illinois",2060,1962,1737,0,0,224,0,0,1,0,1,98,88,0,0,0,0,10,0,0,0,0.156796117
1400000US17031808702,17031808702,"Census Tract 8087.02, Cook County, Illinois",5601,5080,3102,391,0,1317,5,0,265,62,203,521,366,11,6,0,0,64,74,47,27,0.446170327
1400000US17031808800,17031808800,"Census Tract 8088, Cook County, Illinois",3693,3451,3010,129,0,261,0,0,51,0,51,242,160,0,0,0,0,82,0,0,0,0.18494449
1400000US17031808900,17031808900,"Census Tract 8089, Cook County, Illinois",4014,3775,3462,22,0,53,0,9,229,0,229,239,209,0,0,0,0,0,30,0,30,0.137518685
1400000US17031809000,17031809000,"Census Tract 8090, Cook County, Illinois",4164,4097,3755,132,0,130,0,26,54,0,54,67,32,0,0,0,0,35,0,0,0,0.098222863
1400000US17031809100,17031809100,"Census Tract 8091, Cook County, Illinois",3345,3269,2830,173,0,193,0,0,73,0,73,76,73,0,0,0,0,0,3,0,3,0.153961136
1400000US17031809200,17031809200,"Census Tract 8092, Cook County, Illinois",5153,4023,619,3016,0,114,0,0,274,0,274,1130,707,7,0,0,0,282,134,87,47,0.879875801
1400000US17031809300,17031809300,"Census Tract 8093, Cook County, Illinois",4529,4024,2907,303,0,785,0,0,29,0,29,505,398,0,17,0,0,45,45,0,45,0.358136454
1400000US17031809400,17031809400,"Census Tract 8094, Cook County, Illinois",5194,5012,3499,239,12,1189,0,0,73,0,73,182,166,14,0,0,0,0,2,0,2,0.326338082
1400000US17031809500,17031809500,"Census Tract 8095, Cook County, Illinois",3546,3323,2596,184,0,404,0,0,139,0,139,223,191,0,0,0,0,10,22,22,0,0.267907501
1400000US17031809600,17031809600,"Census Tract 8096, Cook County, Illinois",3483,2969,1331,1412,0,175,0,0,51,0,51,514,316,0,0,0,0,191,7,7,0,0.617858168
1400000US17031809700,17031809700,"Census Tract 8097, Cook County, Illinois",3971,2673,1461,890,0,134,0,39,149,28,121,1298,1125,10,0,0,0,143,20,20,0,0.632082599
1400000US17031809800,17031809800,"Census Tract 8098, Cook County, Illinois",3025,2727,2057,373,0,174,0,0,123,0,123,298,298,0,0,0,0,0,0,0,0,0.32
1400000US17031809900,17031809900,"Census Tract 8099, Cook County, Illinois",3009,2922,2484,90,0,301,0,0,47,0,47,87,87,0,0,0,0,0,0,0,0,0.17447657
1400000US17031810000,17031810000,"Census Tract 8100, Cook County, Illinois",4925,4810,3776,227,0,675,0,0,132,0,132,115,73,0,0,18,0,24,0,0,0,0.233299492
1400000US17031810100,17031810100,"Census Tract 8101, Cook County, Illinois",4823,4066,3003,635,0,348,0,28,52,0,52,757,578,73,0,0,0,82,24,24,0,0.377358491
1400000US17031810200,17031810200,"Census Tract 8102, Cook County, Illinois",5939,5452,2010,2964,0,288,0,13,177,0,177,487,331,27,0,11,0,85,33,0,33,0.661559185
1400000US17031810301,17031810301,"Census Tract 8103.01, Cook County, Illinois",3608,2867,1559,1017,15,178,0,20,78,0,78,741,567,0,71,0,0,90,13,0,13,0.567904656
1400000US17031810302,17031810302,"Census Tract 8103.02, Cook County, Illinois",3260,3121,2044,723,0,126,0,7,221,0,221,139,88,0,0,0,0,51,0,0,0,0.373006135
1400000US17031810400,17031810400,"Census Tract 8104, Cook County, Illinois",5381,4898,4748,1,0,138,0,0,11,0,11,483,483,0,0,0,0,0,0,0,0,0.117636127
1400000US17031810501,17031810501,"Census Tract 8105.01, Cook County, Illinois",5105,4593,4309,41,5,238,0,0,0,0,0,512,512,0,0,0,0,0,0,0,0,0.155925563
1400000US17031810502,17031810502,"Census Tract 8105.02, Cook County, Illinois",5064,4656,4257,11,0,342,0,0,46,0,46,408,332,11,0,0,0,55,10,0,10,0.15936019
1400000US17031810600,17031810600,"Census Tract 8106, Cook County, Illinois",4718,4073,3864,36,0,130,0,10,33,11,22,645,428,0,0,42,0,175,0,0,0,0.181008902
1400000US17031810701,17031810701,"Census Tract 8107.01, Cook County, Illinois",5046,3435,3361,20,0,42,0,0,12,5,7,1611,726,0,0,0,0,772,113,113,0,0.333927864
1400000US17031810702,17031810702,"Census Tract 8107.02, Cook County, Illinois",3970,3115,2895,105,0,89,0,0,26,26,0,855,513,79,0,0,0,256,7,0,7,0.270780856
1400000US17031810800,17031810800,"Census Tract 8108, Cook County, Illinois",5515,4322,3831,92,0,288,0,0,111,0,111,1193,646,0,0,0,0,430,117,77,40,0.305349048
1400000US17031810900,17031810900,"Census Tract 8109, Cook County, Illinois",6248,4600,4039,172,28,276,0,0,85,0,85,1648,638,0,86,0,0,875,49,49,0,0.353553137
1400000US17031811000,17031811000,"Census Tract 8110, Cook County, Illinois",4181,3564,3197,125,0,194,0,0,48,0,48,617,554,23,0,0,0,31,9,9,0,0.235350395
1400000US17031811100,17031811100,"Census Tract 8111, Cook County, Illinois",6161,5061,4871,18,0,103,0,0,69,13,56,1100,670,31,0,0,0,333,66,66,0,0.209381594
1400000US17031811200,17031811200,"Census Tract 8112, Cook County, Illinois",5708,3798,3530,26,0,175,0,0,67,29,38,1910,944,0,86,0,0,734,146,83,63,0.381569727
1400000US17031811301,17031811301,"Census Tract 8113.01, Cook County, Illinois",5200,2304,1610,250,0,317,0,26,101,0,101,2896,1435,0,22,15,0,1333,91,72,19,0.690384615
1400000US17031811302,17031811302,"Census Tract 8113.02, Cook County, Illinois",3575,1134,686,325,0,123,0,0,0,0,0,2441,968,62,20,0,0,1245,146,115,31,0.808111888
1400000US17031811401,17031811401,"Census Tract 8114.01, Cook County, Illinois",5177,2849,2628,36,0,108,0,0,77,0,77,2328,1637,60,0,0,0,631,0,0,0,0.492370099
1400000US17031811402,17031811402,"Census Tract 8114.02, Cook County, Illinois",4439,2529,2167,10,0,352,0,0,0,0,0,1910,1083,0,0,0,0,746,81,46,35,0.511826988
1400000US17031811500,17031811500,"Census Tract 8115, Cook County, Illinois",5983,3652,3505,17,0,67,0,0,63,0,63,2331,1202,28,0,0,0,1039,62,0,62,0.414173492
1400000US17031811600,17031811600,"Census Tract 8116, Cook County, Illinois",5982,4358,3609,45,0,557,0,22,125,82,43,1624,774,0,180,15,0,557,98,59,39,0.39669007
1400000US17031811701,17031811701,"Census Tract 8117.01, Cook County, Illinois",3831,1250,1045,17,0,172,0,0,16,0,16,2581,1693,15,0,0,0,810,63,42,21,0.727225268
1400000US17031811702,17031811702,"Census Tract 8117.02, Cook County, Illinois",4653,2485,2237,81,0,118,0,0,49,18,31,2168,828,0,90,0,0,1083,167,126,41,0.519234902
1400000US17031811800,17031811800,"Census Tract 8118, Cook County, Illinois",5561,2515,2302,90,0,89,0,8,26,0,26,3046,1834,0,0,0,0,1194,18,0,18,0.586045675
1400000US17031811900,17031811900,"Census Tract 8119, Cook County, Illinois",5935,5761,4813,469,13,303,0,0,163,18,145,174,133,4,0,0,0,37,0,0,0,0.18904802
1400000US17031812000,17031812000,"Census Tract 8120, Cook County, Illinois",5276,4929,4253,89,0,500,0,0,87,0,87,347,181,29,0,0,0,92,45,13,32,0.193896892
1400000US17031812100,17031812100,"Census Tract 8121, Cook County, Illinois",4351,4003,2143,1459,0,270,0,33,98,0,98,348,112,0,16,0,0,197,23,23,0,0.507469547
1400000US17031812200,17031812200,"Census Tract 8122, Cook County, Illinois",4162,3990,2958,652,0,115,0,62,203,0,203,172,160,0,0,0,0,12,0,0,0,0.289283998
1400000US17031812301,17031812301,"Census Tract 8123.01, Cook County, Illinois",3537,2999,2015,567,0,346,0,0,71,0,71,538,226,35,0,0,0,226,51,0,51,0.430308171
1400000US17031812302,17031812302,"Census Tract 8123.02, Cook County, Illinois",2852,2662,2069,434,0,138,0,0,21,0,21,190,115,0,0,0,0,0,75,22,53,0.27454418
1400000US17031812400,17031812400,"Census Tract 8124, Cook County, Illinois",3550,3456,2775,357,0,164,0,10,150,0,150,94,78,0,0,6,0,10,0,0,0,0.218309859
1400000US17031812500,17031812500,"Census Tract 8125, Cook County, Illinois",3708,3323,1946,1198,0,100,0,0,79,0,79,385,112,75,0,0,0,191,7,7,0,0.475188781
1400000US17031812600,17031812600,"Census Tract 8126, Cook County, Illinois",3395,3125,1850,830,0,250,0,0,195,0,195,270,119,0,0,0,0,113,38,38,0,0.455081001
1400000US17031812700,17031812700,"Census Tract 8127, Cook County, Illinois",3155,2927,2156,499,0,145,0,29,98,0,98,228,107,0,8,0,0,104,9,0,9,0.316640254
1400000US17031812801,17031812801,"Census Tract 8128.01, Cook County, Illinois",2769,2629,1700,677,0,149,0,0,103,93,10,140,95,0,0,0,0,42,3,3,0,0.386059949
1400000US17031812802,17031812802,"Census Tract 8128.02, Cook County, Illinois",2713,2311,1811,288,0,173,0,0,39,0,39,402,201,0,0,0,0,201,0,0,0,0.332473277
1400000US17031812900,17031812900,"Census Tract 8129, Cook County, Illinois",5037,4815,3620,683,0,258,0,0,254,0,254,222,176,2,0,0,0,6,38,13,25,0.281318245
1400000US17031813000,17031813000,"Census Tract 8130, Cook County, Illinois",3415,3195,2251,770,0,104,0,0,70,0,70,220,152,0,0,0,0,0,68,15,53,0.340849195
1400000US17031813100,17031813100,"Census Tract 8131, Cook County, Illinois",4799,4410,2256,1784,12,210,0,19,129,0,129,389,253,0,0,0,0,124,12,12,0,0.529902063
1400000US17031813200,17031813200,"Census Tract 8132, Cook County, Illinois",4545,4394,3305,598,0,299,0,0,192,0,192,151,73,18,0,0,0,52,8,0,8,0.272827283
1400000US17031813301,17031813301,"Census Tract 8133.01, Cook County, Illinois",3431,482,174,250,0,58,0,0,0,0,0,2949,1163,13,0,0,0,1758,15,15,0,0.949285922
1400000US17031813302,17031813302,"Census Tract 8133.02, Cook County, Illinois",3772,314,138,176,0,0,0,0,0,0,0,3458,1505,0,0,0,0,1916,37,17,20,0.963414634
1400000US17031813400,17031813400,"Census Tract 8134, Cook County, Illinois",7914,1060,381,564,0,56,0,0,59,0,59,6854,2565,0,64,0,0,4128,97,97,0,0.951857468
1400000US17031813500,17031813500,"Census Tract 8135, Cook County, Illinois",8203,1198,931,260,0,0,0,7,0,0,0,7005,3039,0,38,0,0,3754,174,153,21,0.886504937
1400000US17031813600,17031813600,"Census Tract 8136, Cook County, Illinois",5212,297,180,78,0,39,0,0,0,0,0,4915,1594,0,21,38,0,3253,9,9,0,0.965464313
1400000US17031813701,17031813701,"Census Tract 8137.01, Cook County, Illinois",3465,362,188,174,0,0,0,0,0,0,0,3103,991,0,87,0,0,1938,87,21,66,0.945743146
1400000US17031813702,17031813702,"Census Tract 8137.02, Cook County, Illinois",4050,700,204,496,0,0,0,0,0,0,0,3350,1193,0,0,0,0,2111,46,46,0,0.94962963
1400000US17031813801,17031813801,"Census Tract 8138.01, Cook County, Illinois",3120,156,99,46,0,11,0,0,0,0,0,2964,1254,0,52,0,0,1624,34,34,0,0.968269231
1400000US17031813802,17031813802,"Census Tract 8138.02, Cook County, Illinois",5243,479,315,109,0,28,27,0,0,0,0,4764,2087,0,0,0,0,2619,58,58,0,0.939919893
1400000US17031813900,17031813900,"Census Tract 8139, Cook County, Illinois",6466,677,504,139,0,12,0,0,22,0,22,5789,2366,130,165,0,0,2984,144,138,6,0.92205382
1400000US17031814000,17031814000,"Census Tract 8140, Cook County, Illinois",5137,964,716,178,7,63,0,0,0,0,0,4173,2203,25,0,0,0,1921,24,24,0,0.860619038
1400000US17031814100,17031814100,"Census Tract 8141, Cook County, Illinois",4306,274,129,126,12,0,0,0,7,0,7,4032,1759,0,0,0,7,2175,91,91,0,0.970041802
1400000US17031814200,17031814200,"Census Tract 8142, Cook County, Illinois",6808,629,537,73,0,3,0,0,16,0,16,6179,2053,80,30,0,0,3825,191,99,92,0.921122209
1400000US17031814300,17031814300,"Census Tract 8143, Cook County, Illinois",4608,368,305,29,0,0,0,0,34,0,34,4240,1239,157,35,0,0,2769,40,0,40,0.933810764
1400000US17031814400,17031814400,"Census Tract 8144, Cook County, Illinois",7609,1579,1522,56,1,0,0,0,0,0,0,6030,2893,0,70,0,0,2921,146,61,85,0.799973715
1400000US17031814500,17031814500,"Census Tract 8145, Cook County, Illinois",5079,866,676,174,0,9,0,0,7,0,7,4213,2080,12,0,0,0,1936,185,60,125,0.866902934
1400000US17031814600,17031814600,"Census Tract 8146, Cook County, Illinois",5350,1992,1194,592,0,139,0,0,67,0,67,3358,1987,11,0,0,0,1170,190,159,31,0.77682243
1400000US17031814700,17031814700,"Census Tract 8147, Cook County, Illinois",6238,2111,1568,192,0,221,0,21,109,0,109,4127,2460,0,0,0,0,1513,154,86,68,0.748637384
1400000US17031814800,17031814800,"Census Tract 8148, Cook County, Illinois",5911,2690,2076,409,0,191,0,0,14,0,14,3221,2687,12,59,0,0,463,0,0,0,0.648790391
1400000US17031814900,17031814900,"Census Tract 8149, Cook County, Illinois",6711,3215,1765,1226,0,131,0,0,93,0,93,3496,2522,31,16,0,0,927,0,0,0,0.736998957
1400000US17031815000,17031815000,"Census Tract 8150, Cook County, Illinois",4307,1543,508,650,0,209,0,0,176,0,176,2764,2069,0,0,0,0,633,62,53,9,0.882052473
1400000US17031815100,17031815100,"Census Tract 8151, Cook County, Illinois",4244,1523,1108,320,0,95,0,0,0,0,0,2721,1681,7,0,0,0,1004,29,29,0,0.738925542
1400000US17031815200,17031815200,"Census Tract 8152, Cook County, Illinois",6377,2404,1857,437,26,64,0,0,20,0,20,3973,2281,13,13,0,0,1645,21,9,12,0.70879724
1400000US17031815300,17031815300,"Census Tract 8153, Cook County, Illinois",3845,1670,1445,96,0,52,0,0,77,0,77,2175,1120,0,0,11,0,914,130,62,68,0.624187256
1400000US17031815400,17031815400,"Census Tract 8154, Cook County, Illinois",5656,3303,2857,124,0,239,0,0,83,0,83,2353,1543,0,0,0,0,721,89,53,36,0.494872702
1400000US17031815500,17031815500,"Census Tract 8155, Cook County, Illinois",8123,2739,2610,14,0,43,0,0,72,0,72,5384,3025,0,27,0,0,2085,247,191,56,0.678690139
1400000US17031815600,17031815600,"Census Tract 8156, Cook County, Illinois",5120,3541,3123,120,0,88,0,0,210,0,210,1579,1456,0,0,0,0,95,28,0,28,0.390039063
1400000US17031815701,17031815701,"Census Tract 8157.01, Cook County, Illinois",3872,3453,3295,32,0,81,0,37,8,0,8,419,365,0,0,0,0,34,20,13,7,0.149018595
1400000US17031815702,17031815702,"Census Tract 8157.02, Cook County, Illinois",5073,4046,3984,32,0,30,0,0,0,0,0,1027,669,44,0,0,0,298,16,0,16,0.214665878
1400000US17031815800,17031815800,"Census Tract 8158, Cook County, Illinois",1557,1454,1378,55,0,9,0,0,12,0,12,103,62,9,0,0,0,20,12,12,0,0.114964676
1400000US17031815900,17031815900,"Census Tract 8159, Cook County, Illinois",4593,4333,2165,1470,0,563,0,14,121,0,121,260,224,0,0,16,0,0,20,20,0,0.528630525
1400000US17031816000,17031816000,"Census Tract 8160, Cook County, Illinois",3396,3122,1810,1150,0,111,0,7,44,6,38,274,254,0,0,0,0,20,0,0,0,0.467020024
1400000US17031816100,17031816100,"Census Tract 8161, Cook County, Illinois",6213,5081,2412,2019,0,540,0,59,51,14,37,1132,572,37,0,0,0,295,228,209,19,0.611781748
1400000US17031816200,17031816200,"Census Tract 8162, Cook County, Illinois",3454,2228,1723,411,8,20,0,0,66,0,66,1226,610,0,0,0,0,511,105,71,34,0.501158078
1400000US17031816300,17031816300,"Census Tract 8163, Cook County, Illinois",5351,1510,1347,83,0,60,0,0,20,0,20,3841,1518,28,0,0,0,2246,49,49,0,0.748271351
1400000US17031816401,17031816401,"Census Tract 8164.01, Cook County, Illinois",5092,715,593,19,0,94,0,0,9,0,9,4377,2086,0,0,0,0,2284,7,7,0,0.883542812
1400000US17031816402,17031816402,"Census Tract 8164.02, Cook County, Illinois",4669,816,630,177,0,0,8,0,1,0,1,3853,1367,107,0,0,0,2334,45,45,0,0.865067466
1400000US17031816500,17031816500,"Census Tract 8165, Cook County, Illinois",4575,774,640,105,0,2,0,0,27,0,27,3801,1689,26,8,0,0,1841,237,196,41,0.86010929
1400000US17031816600,17031816600,"Census Tract 8166, Cook County, Illinois",4770,393,317,25,0,30,0,0,21,0,21,4377,1820,0,0,0,0,2450,107,107,0,0.933542977
1400000US17031816700,17031816700,"Census Tract 8167, Cook County, Illinois",2832,512,329,73,0,75,0,22,13,0,13,2320,1121,41,92,0,0,1004,62,62,0,0.883827684
1400000US17031816800,17031816800,"Census Tract 8168, Cook County, Illinois",5364,3842,1736,1657,23,315,0,0,111,0,111,1522,632,0,0,0,0,890,0,0,0,0.676360925
1400000US17031816900,17031816900,"Census Tract 8169, Cook County, Illinois",5895,4250,433,3619,0,8,0,9,181,0,181,1645,609,213,54,0,0,611,158,146,12,0.926547922
1400000US17031817000,17031817000,"Census Tract 8170, Cook County, Illinois",5054,4047,271,3771,0,3,0,0,2,0,2,1007,521,51,0,0,0,405,30,30,0,0.946379106
1400000US17031817101,17031817101,"Census Tract 8171.01, Cook County, Illinois",4703,4477,166,4120,0,46,0,43,102,57,45,226,111,52,0,0,0,63,0,0,0,0.964703381
1400000US17031817102,17031817102,"Census Tract 8171.02, Cook County, Illinois",3468,3052,161,2852,0,0,0,0,39,0,39,416,33,33,0,0,0,310,40,0,40,0.953575548
1400000US17031817200,17031817200,"Census Tract 8172, Cook County, Illinois",4504,3877,69,3763,0,0,0,0,45,0,45,627,51,22,0,0,0,554,0,0,0,0.984680284
1400000US17031817300,17031817300,"Census Tract 8173, Cook County, Illinois",2377,1813,39,1718,0,19,0,0,37,0,37,564,276,0,0,0,0,278,10,10,0,0.983592764
1400000US17031817400,17031817400,"Census Tract 8174, Cook County, Illinois",4281,1808,660,1133,0,0,0,0,15,0,15,2473,985,41,0,74,0,1373,0,0,0,0.845830413
1400000US17031817500,17031817500,"Census Tract 8175, Cook County, Illinois",3911,3153,206,2932,0,15,0,0,0,0,0,758,249,0,0,0,0,509,0,0,0,0.947328049
1400000US17031817600,17031817600,"Census Tract 8176, Cook County, Illinois",3874,3491,144,3260,0,23,0,0,64,0,64,383,223,0,0,0,0,160,0,0,0,0.962829117
1400000US17031817700,17031817700,"Census Tract 8177, Cook County, Illinois",5201,4740,35,4698,0,7,0,0,0,0,0,461,273,48,0,0,0,140,0,0,0,0.993270525
1400000US17031817900,17031817900,"Census Tract 8179, Cook County, Illinois",5482,5011,1018,3826,0,96,0,0,71,0,71,471,321,116,0,0,0,34,0,0,0,0.81430135
1400000US17031818000,17031818000,"Census Tract 8180, Cook County, Illinois",4451,3915,1831,1935,0,84,0,0,65,0,65,536,292,17,35,0,0,171,21,21,0,0.588631768
1400000US17031818100,17031818100,"Census Tract 8181, Cook County, Illinois",2417,2096,1598,336,0,116,0,0,46,6,40,321,96,0,0,0,0,225,0,0,0,0.338849814
1400000US17031818200,17031818200,"Census Tract 8182, Cook County, Illinois",4554,3589,2242,1168,0,37,0,0,142,10,132,965,779,0,0,0,0,125,61,35,26,0.507685551
1400000US17031818300,17031818300,"Census Tract 8183, Cook County, Illinois",6327,4118,1297,2604,0,77,0,74,66,0,66,2209,712,86,0,0,0,1393,18,18,0,0.795005532
1400000US17031818401,17031818401,"Census Tract 8184.01, Cook County, Illinois",3425,2648,1512,948,9,179,0,0,0,0,0,777,283,0,32,0,0,367,95,95,0,0.558540146
1400000US17031818402,17031818402,"Census Tract 8184.02, Cook County, Illinois",3085,2439,1858,448,0,117,0,0,16,0,16,646,270,0,0,0,0,376,0,0,0,0.397730956
1400000US17031818500,17031818500,"Census Tract 8185, Cook County, Illinois",5557,4957,4287,411,0,235,0,0,24,0,24,600,315,0,0,0,0,160,125,110,15,0.228540579
1400000US17031818600,17031818600,"Census Tract 8186, Cook County, Illinois",4773,4082,3587,365,0,118,0,0,12,0,12,691,691,0,0,0,0,0,0,0,0,0.248481039
1400000US17031818700,17031818700,"Census Tract 8187, Cook County, Illinois",3575,3073,2934,107,0,12,0,0,20,0,20,502,339,0,7,0,0,156,0,0,0,0.179300699
1400000US17031818800,17031818800,"Census Tract 8188, Cook County, Illinois",5630,4769,4602,105,0,40,0,0,22,0,22,861,810,43,0,0,0,8,0,0,0,0.18259325
1400000US17031818900,17031818900,"Census Tract 8189, Cook County, Illinois",4751,4050,3885,108,0,39,0,0,18,0,18,701,671,0,0,9,0,21,0,0,0,0.182277415
1400000US17031819000,17031819000,"Census Tract 8190, Cook County, Illinois",4595,4261,4174,45,0,0,0,0,42,0,42,334,141,0,0,0,0,181,12,0,12,0.091621328
1400000US17031819100,17031819100,"Census Tract 8191, Cook County, Illinois",4358,2357,1925,195,0,102,0,0,135,0,135,2001,1598,0,0,0,0,319,84,30,54,0.558283616
1400000US17031819200,17031819200,"Census Tract 8192, Cook County, Illinois",6383,3506,3121,224,7,94,0,0,60,0,60,2877,2502,0,72,0,0,266,37,37,0,0.511044963
1400000US17031819300,17031819300,"Census Tract 8193, Cook County, Illinois",3028,2660,2345,138,0,36,0,0,141,0,141,368,311,0,0,0,0,44,13,7,6,0.225561427
1400000US17031819400,17031819400,"Census Tract 8194, Cook County, Illinois",5232,3927,3609,47,62,209,0,0,0,0,0,1305,790,0,54,0,0,344,117,101,16,0.310206422
1400000US17031819500,17031819500,"Census Tract 8195, Cook County, Illinois",3119,2650,1965,567,0,75,0,7,36,0,36,469,431,0,0,0,0,23,15,15,0,0.369990382
1400000US17031819600,17031819600,"Census Tract 8196, Cook County, Illinois",3849,3627,3361,224,0,20,0,0,22,0,22,222,156,0,0,0,0,39,27,27,0,0.126786178
1400000US17031819700,17031819700,"Census Tract 8197, Cook County, Illinois",5985,5938,5776,0,0,138,0,0,24,0,24,47,39,0,0,0,0,8,0,0,0,0.034920635
1400000US17031819801,17031819801,"Census Tract 8198.01, Cook County, Illinois",5405,5166,5098,9,0,38,0,0,21,0,21,239,239,0,0,0,0,0,0,0,0,0.05679926
1400000US17031819802,17031819802,"Census Tract 8198.02, Cook County, Illinois",2637,2539,2446,5,0,75,0,0,13,0,13,98,69,0,0,0,0,10,19,15,4,0.072430793
1400000US17031819900,17031819900,"Census Tract 8199, Cook County, Illinois",3416,3277,3234,0,0,7,0,0,36,0,36,139,139,0,0,0,0,0,0,0,0,0.053278689
1400000US17031820000,17031820000,"Census Tract 8200, Cook County, Illinois",2008,1829,1526,13,0,217,0,0,73,0,73,179,179,0,0,0,0,0,0,0,0,0.240039841
1400000US17031820101,17031820101,"Census Tract 8201.01, Cook County, Illinois",7415,7343,6844,185,0,298,0,0,16,9,7,72,59,0,0,0,0,13,0,0,0,0.077006069
1400000US17031820103,17031820103,"Census Tract 8201.03, Cook County, Illinois",3989,2944,2746,90,0,95,0,0,13,0,13,1045,982,0,0,0,0,63,0,0,0,0.311606919
1400000US17031820104,17031820104,"Census Tract 8201.04, Cook County, Illinois",4123,3570,3175,348,11,26,0,0,10,0,10,553,432,0,14,0,0,101,6,3,3,0.229929663
1400000US17031820201,17031820201,"Census Tract 8202.01, Cook County, Illinois",8087,7548,6796,206,0,519,0,15,12,0,12,539,463,0,0,0,0,76,0,0,0,0.159638927
1400000US17031820202,17031820202,"Census Tract 8202.02, Cook County, Illinois",3607,2347,2186,27,99,20,0,0,15,0,15,1260,925,0,11,0,0,324,0,0,0,0.393956196
1400000US17031820300,17031820300,"Census Tract 8203, Cook County, Illinois",5203,2128,1754,128,0,210,0,0,36,0,36,3075,2534,0,0,0,0,493,48,48,0,0.662886796
1400000US17031820400,17031820400,"Census Tract 8204, Cook County, Illinois",6164,1633,707,879,19,27,0,0,1,0,1,4531,3446,0,10,0,0,1002,73,28,45,0.885301752
1400000US17031820501,17031820501,"Census Tract 8205.01, Cook County, Illinois",6260,4985,4651,25,0,292,0,17,0,0,0,1275,1127,0,5,0,0,143,0,0,0,0.257028754
1400000US17031820502,17031820502,"Census Tract 8205.02, Cook County, Illinois",5092,4462,4063,174,0,138,0,0,87,0,87,630,360,0,9,0,0,261,0,0,0,0.202081697
1400000US17031820603,17031820603,"Census Tract 8206.03, Cook County, Illinois",5277,4088,3410,475,0,92,0,0,111,14,97,1189,820,0,8,0,0,338,23,23,0,0.353799507
1400000US17031820604,17031820604,"Census Tract 8206.04, Cook County, Illinois",4152,3630,3348,180,0,0,0,0,102,0,102,522,179,0,0,0,0,308,35,35,0,0.193641618
1400000US17031820605,17031820605,"Census Tract 8206.05, Cook County, Illinois",4169,3630,1364,2229,0,0,0,0,37,0,37,539,425,8,0,0,0,76,30,30,0,0.672823219
1400000US17031820606,17031820606,"Census Tract 8206.06, Cook County, Illinois",3748,3491,3292,50,34,39,0,0,76,0,76,257,101,0,0,0,0,156,0,0,0,0.121664888
1400000US17031820700,17031820700,"Census Tract 8207, Cook County, Illinois",6810,3552,3300,23,0,169,0,0,60,0,60,3258,1762,11,57,0,0,1253,175,175,0,0.515418502
1400000US17031820800,17031820800,"Census Tract 8208, Cook County, Illinois",4223,2111,1882,149,0,64,0,0,16,0,16,2112,1108,22,0,0,0,938,44,44,0,0.554345252
1400000US17031820901,17031820901,"Census Tract 8209.01, Cook County, Illinois",5462,3845,3576,125,0,144,0,0,0,0,0,1617,820,0,12,0,0,755,30,30,0,0.345294764
1400000US17031820902,17031820902,"Census Tract 8209.02, Cook County, Illinois",4774,2913,2449,140,0,300,0,24,0,0,0,1861,965,0,52,0,0,646,198,198,0,0.487012987
1400000US17031821001,17031821001,"Census Tract 8210.01, Cook County, Illinois",5287,4272,3961,64,0,158,0,18,71,0,71,1015,602,13,0,0,0,372,28,28,0,0.250803859
1400000US17031821002,17031821002,"Census Tract 8210.02, Cook County, Illinois",5695,4364,4100,124,0,47,0,0,93,0,93,1331,966,0,74,26,0,265,0,0,0,0.280070237
1400000US17031821101,17031821101,"Census Tract 8211.01, Cook County, Illinois",4548,3487,3200,58,0,211,0,0,18,8,10,1061,810,0,39,0,0,212,0,0,0,0.296394019
1400000US17031821102,17031821102,"Census Tract 8211.02, Cook County, Illinois",4191,2882,2644,33,0,10,0,68,127,31,96,1309,815,0,0,0,0,493,1,1,0,0.369124314
1400000US17031821200,17031821200,"Census Tract 8212, Cook County, Illinois",6240,3761,979,2740,0,1,0,0,41,15,26,2479,985,21,0,0,0,1319,154,11,143,0.843108974
1400000US17031821300,17031821300,"Census Tract 8213, Cook County, Illinois",5488,2742,999,1528,0,92,0,26,97,5,92,2746,1626,16,0,0,0,1104,0,0,0,0.817966472
1400000US17031821401,17031821401,"Census Tract 8214.01, Cook County, Illinois",3432,3139,137,2977,0,0,0,0,25,0,25,293,262,31,0,0,0,0,0,0,0,0.960081585
1400000US17031821402,17031821402,"Census Tract 8214.02, Cook County, Illinois",3718,3675,207,3468,0,0,0,0,0,0,0,43,34,9,0,0,0,0,0,0,0,0.944324906
1400000US17031821500,17031821500,"Census Tract 8215, Cook County, Illinois",2020,1970,18,1932,0,0,0,0,20,0,20,50,45,4,0,0,0,1,0,0,0,0.991089109
1400000US17031821600,17031821600,"Census Tract 8216, Cook County, Illinois",4503,3794,1991,1706,0,0,0,0,97,0,97,709,421,0,0,0,0,251,37,0,37,0.557850322
1400000US17031821700,17031821700,"Census Tract 8217, Cook County, Illinois",4855,4541,3999,431,0,24,0,0,87,0,87,314,310,0,0,0,0,4,0,0,0,0.176313079
1400000US17031821800,17031821800,"Census Tract 8218, Cook County, Illinois",5428,4634,3643,922,0,8,0,0,61,0,61,794,625,0,0,0,0,157,12,0,12,0.328850405
1400000US17031821900,17031821900,"Census Tract 8219, Cook County, Illinois",5138,4684,3754,813,0,117,0,0,0,0,0,454,351,35,0,0,0,68,0,0,0,0.269365512
1400000US17031822000,17031822000,"Census Tract 8220, Cook County, Illinois",4358,3514,3495,0,0,1,0,0,18,0,18,844,697,0,0,0,0,147,0,0,0,0.198026618
1400000US17031822101,17031822101,"Census Tract 8221.01, Cook County, Illinois",4429,3666,3477,95,0,6,0,0,88,0,88,763,443,8,0,0,0,312,0,0,0,0.214946941
1400000US17031822102,17031822102,"Census Tract 8221.02, Cook County, Illinois",4752,3208,2600,445,1,48,0,0,114,0,114,1544,856,43,0,0,0,634,11,1,10,0.452861953
1400000US17031822200,17031822200,"Census Tract 8222, Cook County, Illinois",3786,3063,2913,25,0,15,0,0,110,0,110,723,416,0,13,0,0,290,4,4,0,0.230586371
1400000US17031822301,17031822301,"Census Tract 8223.01, Cook County, Illinois",4119,3550,3251,130,0,16,0,121,32,0,32,569,386,0,0,22,0,114,47,37,10,0.21073076
1400000US17031822302,17031822302,"Census Tract 8223.02, Cook County, Illinois",4530,3820,3006,448,0,204,0,0,162,16,146,710,276,0,8,0,0,416,10,10,0,0.336423841
1400000US17031822400,17031822400,"Census Tract 8224, Cook County, Illinois",6675,5796,5428,82,0,286,0,0,0,0,0,879,798,0,0,0,0,52,29,29,0,0.186816479
1400000US17031822500,17031822500,"Census Tract 8225, Cook County, Illinois",4424,3850,3595,93,0,104,0,0,58,0,58,574,396,0,0,0,0,143,35,26,9,0.18738698
1400000US17031822601,17031822601,"Census Tract 8226.01, Cook County, Illinois",4555,3933,3714,73,13,26,0,0,107,0,107,622,504,13,0,0,0,73,32,32,0,0.184632272
1400000US17031822602,17031822602,"Census Tract 8226.02, Cook County, Illinois",7274,6638,5947,408,0,217,0,0,66,13,53,636,290,0,0,0,0,288,58,15,43,0.182430575
1400000US17031822701,17031822701,"Census Tract 8227.01, Cook County, Illinois",4148,3233,2760,374,0,78,0,0,21,0,21,915,915,0,0,0,0,0,0,0,0,0.334619094
1400000US17031822702,17031822702,"Census Tract 8227.02, Cook County, Illinois",3190,2811,2472,261,0,60,0,0,18,0,18,379,81,0,0,0,0,298,0,0,0,0.22507837
1400000US17031822801,17031822801,"Census Tract 8228.01, Cook County, Illinois",3473,2815,2426,98,0,57,0,0,234,0,234,658,393,0,0,0,0,233,32,0,32,0.301468471
1400000US17031822802,17031822802,"Census Tract 8228.02, Cook County, Illinois",3574,2990,2785,193,0,0,0,0,12,0,12,584,548,0,0,0,0,35,1,1,0,0.220761052
1400000US17031822900,17031822900,"Census Tract 8229, Cook County, Illinois",1974,1523,1405,95,0,23,0,0,0,0,0,451,376,0,0,0,0,75,0,0,0,0.288247214
1400000US17031823001,17031823001,"Census Tract 8230.01, Cook County, Illinois",6009,5018,3761,871,0,182,0,0,204,0,204,991,550,0,0,0,0,441,0,0,0,0.374105508
1400000US17031823002,17031823002,"Census Tract 8230.02, Cook County, Illinois",6045,5080,4642,196,0,100,0,0,142,0,142,965,704,0,0,0,0,261,0,0,0,0.232092639
1400000US17031823101,17031823101,"Census Tract 8231.01, Cook County, Illinois",4395,3902,3692,26,0,140,0,0,44,0,44,493,335,0,0,0,0,140,18,18,0,0.159954494
1400000US17031823102,17031823102,"Census Tract 8231.02, Cook County, Illinois",3722,3567,3545,9,10,0,0,0,3,3,0,155,151,4,0,0,0,0,0,0,0,0.047555078
1400000US17031823200,17031823200,"Census Tract 8232, Cook County, Illinois",4649,4260,3856,211,9,114,0,0,70,0,70,389,304,7,12,0,0,55,11,0,11,0.170574317
1400000US17031823302,17031823302,"Census Tract 8233.02, Cook County, Illinois",6234,4374,2308,1851,0,101,0,0,114,0,114,1860,964,0,0,0,0,896,0,0,0,0.629772217
1400000US17031823303,17031823303,"Census Tract 8233.03, Cook County, Illinois",4682,3769,3391,293,0,42,0,0,43,0,43,913,323,0,0,0,0,576,14,14,0,0.275736865
1400000US17031823304,17031823304,"Census Tract 8233.04, Cook County, Illinois",6096,4518,3624,804,5,63,0,0,22,0,22,1578,997,0,0,0,0,489,92,92,0,0.405511811
1400000US17031823400,17031823400,"Census Tract 8234, Cook County, Illinois",5064,2255,1287,927,0,0,0,0,41,41,0,2809,1391,70,30,0,0,1163,155,83,72,0.745853081
1400000US17031823500,17031823500,"Census Tract 8235, Cook County, Illinois",4896,2468,1837,482,7,45,0,44,53,0,53,2428,1538,0,17,0,0,838,35,35,0,0.624795752
1400000US17031823602,17031823602,"Census Tract 8236.02, Cook County, Illinois",6152,5862,5557,144,0,123,0,0,38,0,38,290,196,0,0,0,0,94,0,0,0,0.096716515
1400000US17031823603,17031823603,"Census Tract 8236.03, Cook County, Illinois",2384,1221,79,1142,0,0,0,0,0,0,0,1163,203,0,0,0,0,937,23,23,0,0.966862416
1400000US17031823604,17031823604,"Census Tract 8236.04, Cook County, Illinois",3587,3564,3338,110,0,103,0,0,13,0,13,23,15,0,0,0,0,0,8,8,0,0.06941734
1400000US17031823605,17031823605,"Census Tract 8236.05, Cook County, Illinois",4268,4004,3692,156,5,54,0,0,97,17,80,264,264,0,0,0,0,0,0,0,0,0.134957826
1400000US17031823702,17031823702,"Census Tract 8237.02, Cook County, Illinois",6888,6246,5127,766,0,213,0,61,79,55,24,642,461,0,14,0,0,106,61,61,0,0.255662021
1400000US17031823703,17031823703,"Census Tract 8237.03, Cook County, Illinois",7414,6434,5530,34,0,451,0,0,419,16,403,980,665,21,0,0,0,243,51,51,0,0.254113839
1400000US17031823704,17031823704,"Census Tract 8237.04, Cook County, Illinois",4187,3613,3345,41,0,102,0,0,125,22,103,574,298,0,0,0,0,276,0,0,0,0.201098639
1400000US17031823705,17031823705,"Census Tract 8237.05, Cook County, Illinois",4849,4136,3857,165,0,41,0,0,73,5,68,713,446,49,0,0,1,217,0,0,0,0.204578264
1400000US17031823801,17031823801,"Census Tract 8238.01, Cook County, Illinois",5394,5253,4945,13,0,229,0,0,66,0,66,141,126,0,0,0,0,0,15,0,15,0.083240638
1400000US17031823803,17031823803,"Census Tract 8238.03, Cook County, Illinois",7011,6407,5774,85,0,346,0,79,123,0,123,604,572,0,0,0,0,32,0,0,0,0.176437028
1400000US17031823805,17031823805,"Census Tract 8238.05, Cook County, Illinois",2898,2748,2688,42,0,11,0,0,7,0,7,150,103,0,0,0,0,47,0,0,0,0.072463768
1400000US17031823806,17031823806,"Census Tract 8238.06, Cook County, Illinois",3575,3216,2937,226,38,0,0,0,15,0,15,359,204,20,0,0,0,135,0,0,0,0.178461538
1400000US17031823901,17031823901,"Census Tract 8239.01, Cook County, Illinois",3851,3725,3339,115,0,214,0,0,57,43,14,126,26,0,90,0,0,10,0,0,0,0.13295248
1400000US17031823903,17031823903,"Census Tract 8239.03, Cook County, Illinois",4715,4249,4040,147,0,47,0,4,11,0,11,466,391,0,0,0,0,75,0,0,0,0.143160127
1400000US17031823904,17031823904,"Census Tract 8239.04, Cook County, Illinois",4137,3909,3771,11,0,96,0,0,31,0,31,228,228,0,0,0,0,0,0,0,0,0.088469906
1400000US17031824003,17031824003,"Census Tract 8240.03, Cook County, Illinois",6208,5850,5623,12,0,63,0,14,138,0,138,358,329,0,0,0,0,29,0,0,0,0.094233247
1400000US17031824004,17031824004,"Census Tract 8240.04, Cook County, Illinois",5507,5190,4864,151,0,90,0,50,35,23,12,317,267,0,0,0,0,38,12,12,0,0.116760487
1400000US17031824005,17031824005,"Census Tract 8240.05, Cook County, Illinois",5571,5065,4816,65,0,61,0,15,108,0,108,506,116,35,0,0,0,317,38,38,0,0.135523245
1400000US17031824006,17031824006,"Census Tract 8240.06, Cook County, Illinois",4143,3766,3734,0,0,15,0,0,17,0,17,377,310,0,0,0,0,9,58,22,36,0.098720734
1400000US17031824105,17031824105,"Census Tract 8241.05, Cook County, Illinois",6399,6109,5332,62,0,586,0,0,129,0,129,290,273,0,0,17,0,0,0,0,0,0.166744804
1400000US17031824106,17031824106,"Census Tract 8241.06, Cook County, Illinois",7149,6665,5659,251,0,539,0,0,216,0,216,484,329,0,0,0,0,1,154,0,154,0.208420758
1400000US17031824107,17031824107,"Census Tract 8241.07, Cook County, Illinois",6617,5971,5556,342,0,68,0,0,5,0,5,646,416,0,0,0,0,217,13,13,0,0.160344567
1400000US17031824108,17031824108,"Census Tract 8241.08, Cook County, Illinois",7684,7048,5817,482,27,478,0,0,244,25,219,636,269,0,80,0,0,244,43,43,0,0.24297241
1400000US17031824113,17031824113,"Census Tract 8241.13, Cook County, Illinois",7166,6264,5729,59,0,326,0,14,136,0,136,902,799,0,0,0,0,103,0,0,0,0.200530282
1400000US17031824114,17031824114,"Census Tract 8241.14, Cook County, Illinois",4941,4591,4225,41,0,325,0,0,0,0,0,350,290,60,0,0,0,0,0,0,0,0.144909937
1400000US17031824115,17031824115,"Census Tract 8241.15, Cook County, Illinois",3602,3341,3093,69,18,114,0,0,47,0,47,261,156,0,0,0,0,105,0,0,0,0.141310383
1400000US17031824116,17031824116,"Census Tract 8241.16, Cook County, Illinois",4874,4205,3779,19,15,217,0,0,175,45,130,669,417,0,0,0,0,252,0,0,0,0.224661469
1400000US17031824117,17031824117,"Census Tract 8241.17, Cook County, Illinois",9883,9247,8289,181,0,698,0,15,64,0,64,636,501,0,0,12,0,83,40,40,0,0.161287059
1400000US17031824119,17031824119,"Census Tract 8241.19, Cook County, Illinois",6000,5767,5216,75,0,449,0,0,27,0,27,233,233,0,0,0,0,0,0,0,0,0.130666667
1400000US17031824120,17031824120,"Census Tract 8241.20, Cook County, Illinois",8612,8382,7550,285,0,468,0,0,79,0,79,230,230,0,0,0,0,0,0,0,0,0.123316303
1400000US17031824121,17031824121,"Census Tract 8241.21, Cook County, Illinois",3297,3219,2960,95,0,66,0,0,98,8,90,78,61,0,0,0,0,17,0,0,0,0.102214134
1400000US17031824122,17031824122,"Census Tract 8241.22, Cook County, Illinois",6075,5706,5285,141,0,218,62,0,0,0,0,369,185,0,0,0,0,184,0,0,0,0.130041152
1400000US17031824123,17031824123,"Census Tract 8241.23, Cook County, Illinois",8552,7316,6601,364,0,266,0,31,54,20,34,1236,977,0,0,0,0,181,78,78,0,0.22813377
1400000US17031824300,17031824300,"Census Tract 8243, Cook County, Illinois",4885,4617,184,4409,13,11,0,0,0,0,0,268,106,9,0,0,0,153,0,0,0,0.962333675
1400000US17031824400,17031824400,"Census Tract 8244, Cook County, Illinois",2309,1994,972,1009,13,0,0,0,0,0,0,315,218,0,0,0,0,97,0,0,0,0.579038545
1400000US17031824503,17031824503,"Census Tract 8245.03, Cook County, Illinois",6602,6292,5925,186,0,169,0,0,12,0,12,310,242,0,0,0,0,68,0,0,0,0.102544683
1400000US17031824505,17031824505,"Census Tract 8245.05, Cook County, Illinois",7161,6251,5702,386,31,15,0,0,117,46,71,910,619,0,0,0,0,291,0,0,0,0.203742494
1400000US17031824506,17031824506,"Census Tract 8245.06, Cook County, Illinois",7855,7455,6615,174,0,447,0,0,219,0,219,400,240,0,92,0,0,68,0,0,0,0.157861235
1400000US17031824507,17031824507,"Census Tract 8245.07, Cook County, Illinois",4449,3817,3424,105,10,142,0,0,136,0,136,632,246,0,0,0,0,260,126,116,10,0.230388851
1400000US17031824601,17031824601,"Census Tract 8246.01, Cook County, Illinois",4805,4084,3814,179,0,30,0,0,61,10,51,721,620,0,0,0,0,101,0,0,0,0.206243496
1400000US17031824602,17031824602,"Census Tract 8246.02, Cook County, Illinois",6838,5731,5435,223,33,40,0,0,0,0,0,1107,618,0,0,0,0,469,20,20,0,0.205176952
1400000US17031824701,17031824701,"Census Tract 8247.01, Cook County, Illinois",3949,3054,2530,326,0,178,0,0,20,0,20,895,481,0,0,0,0,290,124,124,0,0.359331476
1400000US17031824702,17031824702,"Census Tract 8247.02, Cook County, Illinois",5650,4121,2975,646,0,115,0,0,385,0,385,1529,941,5,77,7,0,269,230,230,0,0.473451327
1400000US17031824800,17031824800,"Census Tract 8248, Cook County, Illinois",7758,3903,1819,2084,0,0,0,0,0,0,0,3855,2236,0,41,0,0,1557,21,0,21,0.765532354
1400000US17031824900,17031824900,"Census Tract 8249, Cook County, Illinois",3124,2699,706,1943,0,0,0,15,35,35,0,425,244,0,0,0,0,114,67,67,0,0.774007682
1400000US17031825000,17031825000,"Census Tract 8250, Cook County, Illinois",4933,4397,3559,431,0,205,0,7,195,0,195,536,456,0,46,0,0,0,34,22,12,0.278532333
1400000US17031825200,17031825200,"Census Tract 8252, Cook County, Illinois",1862,1492,1118,123,46,72,0,81,52,0,52,370,271,0,9,0,0,90,0,0,0,0.399570354
1400000US17031825302,17031825302,"Census Tract 8253.02, Cook County, Illinois",5625,4693,4360,267,0,48,0,0,18,0,18,932,667,0,0,0,0,199,66,46,20,0.224888889
1400000US17031825303,17031825303,"Census Tract 8253.03, Cook County, Illinois",4048,3372,3204,82,0,44,0,0,42,0,42,676,120,0,0,0,0,556,0,0,0,0.208498024
1400000US17031825304,17031825304,"Census Tract 8253.04, Cook County, Illinois",3926,3628,3287,197,0,80,0,0,64,0,64,298,193,0,0,0,0,53,52,52,0,0.16276108
1400000US17031825400,17031825400,"Census Tract 8254, Cook County, Illinois",5395,4769,4309,224,20,189,0,0,27,0,27,626,375,0,0,0,0,242,9,9,0,0.201297498
1400000US17031825501,17031825501,"Census Tract 8255.01, Cook County, Illinois",5723,5221,683,4455,15,10,0,19,39,0,39,502,291,75,0,0,0,50,86,86,0,0.880656998
1400000US17031825503,17031825503,"Census Tract 8255.03, Cook County, Illinois",7215,6641,834,5658,0,53,0,0,96,25,71,574,59,62,0,0,0,400,53,53,0,0.884407484
1400000US17031825504,17031825504,"Census Tract 8255.04, Cook County, Illinois",3780,3743,254,3427,0,21,0,0,41,0,41,37,10,13,0,0,0,14,0,0,0,0.932804233
1400000US17031825505,17031825505,"Census Tract 8255.05, Cook County, Illinois",5291,5179,629,4527,0,0,0,0,23,0,23,112,104,8,0,0,0,0,0,0,0,0.881118881
1400000US17031825600,17031825600,"Census Tract 8256, Cook County, Illinois",5612,4965,481,4417,0,45,0,0,22,0,22,647,512,0,0,0,0,135,0,0,0,0.914290805
1400000US17031825700,17031825700,"Census Tract 8257, Cook County, Illinois",4225,3312,582,2631,0,88,0,0,11,0,11,913,746,35,0,0,0,116,16,16,0,0.862248521
1400000US17031825801,17031825801,"Census Tract 8258.01, Cook County, Illinois",3705,3670,269,3270,64,0,0,0,67,0,67,35,0,35,0,0,0,0,0,0,0,0.927395412
1400000US17031825802,17031825802,"Census Tract 8258.02, Cook County, Illinois",5234,4551,392,4044,0,73,0,0,42,0,42,683,475,0,0,0,0,41,167,0,167,0.925105082
1400000US17031825803,17031825803,"Census Tract 8258.03, Cook County, Illinois",5026,4258,541,3675,0,20,0,0,22,0,22,768,305,15,0,0,0,448,0,0,0,0.892359729
1400000US17031825900,17031825900,"Census Tract 8259, Cook County, Illinois",3520,2575,528,2036,0,5,0,0,6,0,6,945,730,31,0,0,0,184,0,0,0,0.85
1400000US17031826000,17031826000,"Census Tract 8260, Cook County, Illinois",3466,2424,441,1953,22,0,0,0,8,0,8,1042,962,38,0,0,0,42,0,0,0,0.872763993
1400000US17031826100,17031826100,"Census Tract 8261, Cook County, Illinois",7156,5851,1245,4527,0,18,0,0,61,0,61,1305,863,57,0,0,0,291,94,94,0,0.826020123
1400000US17031826201,17031826201,"Census Tract 8262.01, Cook County, Illinois",3691,3567,517,3001,0,5,0,0,44,0,44,124,58,62,0,0,0,4,0,0,0,0.859929558
1400000US17031826202,17031826202,"Census Tract 8262.02, Cook County, Illinois",5977,5244,1072,3915,0,0,0,0,257,23,234,733,561,10,0,9,0,74,79,30,49,0.820645809
1400000US17031826301,17031826301,"Census Tract 8263.01, Cook County, Illinois",4165,3810,234,3536,0,13,0,0,27,0,27,355,176,128,0,0,0,4,47,0,47,0.943817527
1400000US17031826303,17031826303,"Census Tract 8263.03, Cook County, Illinois",4260,4241,206,3913,0,51,0,0,71,0,71,19,0,19,0,0,0,0,0,0,0,0.951643192
1400000US17031826304,17031826304,"Census Tract 8263.04, Cook County, Illinois",3091,2957,42,2915,0,0,0,0,0,0,0,134,58,14,0,0,0,62,0,0,0,0.986412164
1400000US17031826401,17031826401,"Census Tract 8264.01, Cook County, Illinois",4140,3864,73,3716,0,0,0,0,75,0,75,276,186,6,0,0,0,84,0,0,0,0.98236715
1400000US17031826402,17031826402,"Census Tract 8264.02, Cook County, Illinois",5208,4860,343,4428,0,0,0,0,89,0,89,348,198,24,9,0,0,62,55,23,32,0.934139785
1400000US17031826500,17031826500,"Census Tract 8265, Cook County, Illinois",6469,6358,368,5906,0,0,0,0,84,0,84,111,0,55,0,0,0,7,49,39,10,0.94311331
1400000US17031826600,17031826600,"Census Tract 8266, Cook County, Illinois",6026,5913,212,5524,0,0,0,0,177,0,177,113,102,11,0,0,0,0,0,0,0,0.964819117
1400000US17031826700,17031826700,"Census Tract 8267, Cook County, Illinois",5204,5186,205,4853,0,0,0,0,128,0,128,18,18,0,0,0,0,0,0,0,0,0.960607225
1400000US17031826800,17031826800,"Census Tract 8268, Cook County, Illinois",4767,2496,489,1860,54,0,0,0,93,0,93,2271,1256,9,0,10,0,965,31,0,31,0.897419761
1400000US17031826901,17031826901,"Census Tract 8269.01, Cook County, Illinois",1579,1464,1,1443,20,0,0,0,0,0,0,115,14,2,0,0,0,99,0,0,0,0.999366688
1400000US17031826902,17031826902,"Census Tract 8269.02, Cook County, Illinois",1090,1071,3,1063,0,5,0,0,0,0,0,19,8,0,9,0,0,2,0,0,0,0.997247706
1400000US17031827000,17031827000,"Census Tract 8270, Cook County, Illinois",3735,3396,23,3359,0,3,0,0,11,0,11,339,119,0,0,0,0,220,0,0,0,0.993842035
1400000US17031827100,17031827100,"Census Tract 8271, Cook County, Illinois",2592,2538,75,2037,0,120,0,39,267,0,267,54,0,0,0,0,0,36,18,18,0,0.971064815
1400000US17031827200,17031827200,"Census Tract 8272, Cook County, Illinois",4330,3316,330,2933,0,4,0,4,45,0,45,1014,866,3,0,0,0,145,0,0,0,0.923787529
1400000US17031827300,17031827300,"Census Tract 8273, Cook County, Illinois",3295,3103,126,2892,10,0,0,50,25,19,6,192,146,0,0,0,0,46,0,0,0,0.961760243
1400000US17031827400,17031827400,"Census Tract 8274, Cook County, Illinois",4594,4415,51,4359,0,2,3,0,0,0,0,179,6,13,0,0,0,128,32,32,0,0.988898563
1400000US17031827500,17031827500,"Census Tract 8275, Cook County, Illinois",5368,3107,341,2766,0,0,0,0,0,0,0,2261,1135,0,0,0,0,1095,31,31,0,0.93647541
1400000US17031827600,17031827600,"Census Tract 8276, Cook County, Illinois",3545,3532,39,3479,0,0,0,0,14,0,14,13,7,0,0,0,0,0,6,6,0,0.98899859
1400000US17031827700,17031827700,"Census Tract 8277, Cook County, Illinois",2907,2695,449,2211,0,9,0,0,26,0,26,212,62,0,0,0,0,142,8,8,0,0.845545236
1400000US17031827801,17031827801,"Census Tract 8278.01, Cook County, Illinois",4752,4287,1331,2805,0,84,0,0,67,0,67,465,428,9,0,0,9,19,0,0,0,0.719907407
1400000US17031827802,17031827802,"Census Tract 8278.02, Cook County, Illinois",3602,3561,494,2999,0,10,0,0,58,0,58,41,0,0,0,0,0,41,0,0,0,0.86285397
1400000US17031827804,17031827804,"Census Tract 8278.04, Cook County, Illinois",3089,3069,506,2531,0,32,0,0,0,0,0,20,0,0,0,0,0,0,20,0,20,0.836192943
1400000US17031827805,17031827805,"Census Tract 8278.05, Cook County, Illinois",3092,3067,536,2531,0,0,0,0,0,0,0,25,25,0,0,0,0,0,0,0,0,0.826649418
1400000US17031827901,17031827901,"Census Tract 8279.01, Cook County, Illinois",2456,2375,282,2056,0,22,0,0,15,4,11,81,76,0,0,0,0,5,0,0,0,0.885179153
1400000US17031827902,17031827902,"Census Tract 8279.02, Cook County, Illinois",4442,3518,1591,1871,0,26,0,0,30,0,30,924,638,49,5,0,0,198,34,29,5,0.641828005
1400000US17031828000,17031828000,"Census Tract 8280, Cook County, Illinois",5258,4171,2415,1698,0,11,0,0,47,0,47,1087,430,0,0,0,0,567,90,82,8,0.540699886
1400000US17031828100,17031828100,"Census Tract 8281, Cook County, Illinois",4740,4067,3172,740,0,112,0,0,43,0,43,673,381,0,0,0,0,292,0,0,0,0.330801688
1400000US17031828201,17031828201,"Census Tract 8282.01, Cook County, Illinois",4290,3938,1920,1930,0,44,0,0,44,0,44,352,166,18,6,0,0,141,21,21,0,0.552447552
1400000US17031828202,17031828202,"Census Tract 8282.02, Cook County, Illinois",4558,4198,2251,1816,0,93,0,0,38,0,38,360,182,0,0,0,0,132,46,18,28,0.506143045
1400000US17031828300,17031828300,"Census Tract 8283, Cook County, Illinois",3728,3258,2389,832,0,5,0,11,21,0,21,470,196,0,9,0,0,265,0,0,0,0.35917382
1400000US17031828401,17031828401,"Census Tract 8284.01, Cook County, Illinois",3681,3294,2266,892,0,38,0,27,71,0,71,387,191,0,0,0,0,187,9,9,0,0.384406411
1400000US17031828402,17031828402,"Census Tract 8284.02, Cook County, Illinois",3950,3349,1630,1647,15,12,0,25,20,0,20,601,224,0,24,0,0,353,0,0,0,0.587341772
1400000US17031828503,17031828503,"Census Tract 8285.03, Cook County, Illinois",4781,4417,1124,3229,0,0,0,0,64,0,64,364,321,0,0,0,0,43,0,0,0,0.76490274
1400000US17031828504,17031828504,"Census Tract 8285.04, Cook County, Illinois",5862,5237,1606,3494,0,8,0,10,119,0,119,625,136,115,0,0,0,262,112,99,13,0.726032071
1400000US17031828505,17031828505,"Census Tract 8285.05, Cook County, Illinois",6488,5730,3074,2435,0,102,0,0,119,0,119,758,435,106,0,0,0,126,91,91,0,0.526202219
1400000US17031828506,17031828506,"Census Tract 8285.06, Cook County, Illinois",9252,8257,2693,5408,0,83,0,0,73,0,73,995,766,66,0,0,0,163,0,0,0,0.708927799
1400000US17031828601,17031828601,"Census Tract 8286.01, Cook County, Illinois",4058,3725,3120,553,0,25,0,0,27,0,27,333,205,0,0,0,0,99,29,29,0,0.231148349
1400000US17031828602,17031828602,"Census Tract 8286.02, Cook County, Illinois",4670,4497,1977,2076,0,91,0,37,316,0,316,173,57,0,0,0,0,116,0,0,0,0.576659529
1400000US17031828701,17031828701,"Census Tract 8287.01, Cook County, Illinois",3604,3289,1304,1810,36,1,0,5,133,0,133,315,172,0,97,0,0,34,12,1,11,0.6381798
1400000US17031828702,17031828702,"Census Tract 8287.02, Cook County, Illinois",5212,4831,850,3890,0,0,0,0,91,0,91,381,240,52,0,0,0,53,36,36,0,0.836914812
1400000US17031828801,17031828801,"Census Tract 8288.01, Cook County, Illinois",5117,4307,2120,1899,1,60,0,0,227,18,209,810,540,48,0,6,0,161,55,55,0,0.585694743
1400000US17031828802,17031828802,"Census Tract 8288.02, Cook County, Illinois",3557,2771,1788,887,0,0,0,0,96,0,96,786,702,0,0,0,0,84,0,0,0,0.49732921
1400000US17031828900,17031828900,"Census Tract 8289, Cook County, Illinois",3494,2014,482,1458,21,0,0,44,9,0,9,1480,559,0,0,0,0,848,73,0,73,0.862049227
1400000US17031829000,17031829000,"Census Tract 8290, Cook County, Illinois",1481,1468,8,1460,0,0,0,0,0,0,0,13,2,0,7,0,0,2,2,2,0,0.994598244
1400000US17031829100,17031829100,"Census Tract 8291, Cook County, Illinois",3793,1084,512,484,34,0,0,0,54,46,8,2709,1282,0,60,0,0,1367,0,0,0,0.8650145
1400000US17031829200,17031829200,"Census Tract 8292, Cook County, Illinois",6143,3311,1629,1649,0,0,0,0,33,0,33,2832,1824,81,0,0,0,731,196,196,0,0.73482012
1400000US17031829301,17031829301,"Census Tract 8293.01, Cook County, Illinois",3716,3327,1482,1763,0,25,0,9,48,0,48,389,130,0,0,0,0,259,0,0,0,0.601184069
1400000US17031829302,17031829302,"Census Tract 8293.02, Cook County, Illinois",3967,2782,354,2373,0,0,0,0,55,0,55,1185,480,0,0,0,0,705,0,0,0,0.910763801
1400000US17031829401,17031829401,"Census Tract 8294.01, Cook County, Illinois",1544,1439,5,1349,10,0,0,0,75,0,75,105,16,58,0,0,0,31,0,0,0,0.996761658
1400000US17031829402,17031829402,"Census Tract 8294.02, Cook County, Illinois",3363,3217,911,2190,0,70,0,0,46,0,46,146,132,0,0,0,0,14,0,0,0,0.729110913
1400000US17031829500,17031829500,"Census Tract 8295, Cook County, Illinois",4154,2682,1736,787,0,0,0,0,159,0,159,1472,634,0,21,0,0,817,0,0,0,0.582089552
1400000US17031829600,17031829600,"Census Tract 8296, Cook County, Illinois",3043,2504,2244,123,0,91,0,0,46,0,46,539,351,0,0,0,0,115,73,0,73,0.262569832
1400000US17031829700,17031829700,"Census Tract 8297, Cook County, Illinois",4168,4093,809,3150,0,25,0,0,109,0,109,75,7,0,0,0,0,68,0,0,0,0.805902111
1400000US17031829800,17031829800,"Census Tract 8298, Cook County, Illinois",6543,6285,3669,2168,3,123,0,67,255,0,255,258,173,67,18,0,0,0,0,0,0,0.439248051
1400000US17031829901,17031829901,"Census Tract 8299.01, Cook County, Illinois",9136,8277,2548,5134,93,220,0,18,264,0,264,859,516,194,0,0,0,149,0,0,0,0.721103327
1400000US17031829902,17031829902,"Census Tract 8299.02, Cook County, Illinois",6377,6237,719,5453,0,36,0,0,29,0,29,140,99,41,0,0,0,0,0,0,0,0.887251058
1400000US17031830001,17031830001,"Census Tract 8300.01, Cook County, Illinois",2263,2062,1931,101,0,30,0,0,0,0,0,201,201,0,0,0,0,0,0,0,0,0.14670791
1400000US17031830003,17031830003,"Census Tract 8300.03, Cook County, Illinois",7952,7724,542,7072,0,4,0,0,106,9,97,228,38,0,0,0,0,190,0,0,0,0.931841046
1400000US17031830004,17031830004,"Census Tract 8300.04, Cook County, Illinois",7108,6945,770,6120,0,55,0,0,0,0,0,163,115,0,14,0,0,3,31,14,17,0.891671356
1400000US17031830005,17031830005,"Census Tract 8300.05, Cook County, Illinois",4192,4152,994,2994,0,105,0,0,59,0,59,40,40,0,0,0,0,0,0,0,0,0.762881679
1400000US17031830006,17031830006,"Census Tract 8300.06, Cook County, Illinois",2263,2136,728,1339,0,0,0,0,69,0,69,127,72,0,0,0,0,55,0,0,0,0.678303137
1400000US17031830007,17031830007,"Census Tract 8300.07, Cook County, Illinois",4565,4265,946,3137,0,182,0,0,0,0,0,300,53,0,33,0,0,182,32,0,32,0.792771084
1400000US17031830008,17031830008,"Census Tract 8300.08, Cook County, Illinois",4595,4492,474,3861,0,49,0,21,87,0,87,103,80,0,0,0,0,13,10,0,10,0.896844396
1400000US17031830100,17031830100,"Census Tract 8301, Cook County, Illinois",3306,2835,438,2166,0,6,0,38,187,17,170,471,194,27,0,0,0,236,14,0,14,0.867513612
1400000US17031830201,17031830201,"Census Tract 8302.01, Cook County, Illinois",5967,5947,1025,4615,12,181,0,0,114,0,114,20,20,0,0,0,0,0,0,0,0,0.828221887
1400000US17031830202,17031830202,"Census Tract 8302.02, Cook County, Illinois",3757,3666,1343,2241,9,21,0,0,52,0,52,91,40,23,0,0,0,0,28,28,0,0.642533937
1400000US17031830300,17031830300,"Census Tract 8303, Cook County, Illinois",4743,4502,1149,3286,0,0,0,37,30,0,30,241,165,20,0,0,0,1,55,0,55,0.757748261
1400000US17031830400,17031830400,"Census Tract 8304, Cook County, Illinois",4359,3970,1390,2463,0,0,0,0,117,0,117,389,209,35,0,0,0,98,47,37,10,0.681119523
1400000US17031830500,17031830500,"Census Tract 8305, Cook County, Illinois",4306,113,98,15,0,0,0,0,0,0,0,4193,3197,0,134,0,0,829,33,33,0,0.977241059
1400000US17031830600,17031830600,"Census Tract 8306, Cook County, Illinois",4854,2593,1600,602,0,237,0,26,128,0,128,2261,1320,89,89,8,0,701,54,19,35,0.670374948
1400000US17031830700,17031830700,"Census Tract 8307, Cook County, Illinois",3561,3054,1630,1131,6,103,25,9,150,0,150,507,292,18,0,0,0,172,25,25,0,0.542263409
1400000US17031830800,17031830800,"Census Tract 8308, Cook County, Illinois",2500,2286,1770,191,0,225,0,0,100,0,100,214,95,32,0,8,0,39,40,40,0,0.292
1400000US17031830900,17031830900,"Census Tract 8309, Cook County, Illinois",2868,1723,1500,65,0,45,0,0,113,0,113,1145,939,11,0,0,0,124,71,37,34,0.476987448
1400000US17031831000,17031831000,"Census Tract 8310, Cook County, Illinois",2326,2166,1809,70,0,234,0,0,53,0,53,160,108,0,0,0,0,41,11,11,0,0.222269991
1400000US17031831100,17031831100,"Census Tract 8311, Cook County, Illinois",7643,3364,2579,190,0,382,0,18,195,0,195,4279,3301,73,0,0,0,788,117,101,16,0.662567055
1400000US17031831200,17031831200,"Census Tract 8312, Cook County, Illinois",5017,407,241,156,0,0,0,0,10,0,10,4610,2102,0,8,0,0,2319,181,160,21,0.951963325
1400000US17031831300,17031831300,"Census Tract 8313, Cook County, Illinois",1206,427,3,422,0,0,0,0,2,0,2,779,280,0,0,0,0,383,116,116,0,0.997512438
1400000US17031831400,17031831400,"Census Tract 8314, Cook County, Illinois",2781,2341,302,1979,10,50,0,0,0,0,0,440,118,0,0,0,0,314,8,8,0,0.891405969
1400000US17031831500,17031831500,"Census Tract 8315, Cook County, Illinois",3595,1702,1097,203,0,70,0,0,332,0,332,1893,1314,9,0,0,0,570,0,0,0,0.694853964
1400000US17031831600,17031831600,"Census Tract 8316, Cook County, Illinois",6922,2448,1597,404,6,364,0,27,50,0,50,4474,2215,28,3,0,0,2123,105,76,29,0.769286333
1400000US17031831700,17031831700,"Census Tract 8317, Cook County, Illinois",2313,1035,722,119,0,99,0,0,95,0,95,1278,536,31,39,0,0,554,118,118,0,0.687851275
1400000US17031831800,17031831800,"Census Tract 8318, Cook County, Illinois",6042,4197,2511,261,0,1251,0,0,174,3,171,1845,712,132,0,0,0,811,190,0,190,0.584409136
1400000US17031831900,17031831900,"Census Tract 8319, Cook County, Illinois",2619,2507,2175,1,0,259,0,0,72,30,42,112,103,0,0,0,0,0,9,9,0,0.169530355
1400000US17031832000,17031832000,"Census Tract 8320, Cook County, Illinois",2181,1867,1721,62,0,35,0,0,49,0,49,314,233,0,0,0,0,81,0,0,0,0.210912425
1400000US17031832100,17031832100,"Census Tract 8321, Cook County, Illinois",3252,3055,2039,680,30,226,0,0,80,6,74,197,174,0,0,0,0,23,0,0,0,0.37300123
1400000US17031832200,17031832200,"Census Tract 8322, Cook County, Illinois",3174,2625,2292,93,0,137,0,7,96,0,96,549,373,0,0,20,0,64,92,83,9,0.277882798
1400000US17031832300,17031832300,"Census Tract 8323, Cook County, Illinois",1975,1692,1386,54,0,133,0,0,119,0,119,283,224,0,0,0,0,59,0,0,0,0.298227848
1400000US17031832400,17031832400,"Census Tract 8324, Cook County, Illinois",3387,1851,1517,63,0,209,0,0,62,0,62,1536,1296,23,9,0,0,196,12,4,8,0.552111013
1400000US17031832500,17031832500,"Census Tract 8325, Cook County, Illinois",3774,3397,2994,246,0,80,0,0,77,0,77,377,257,5,20,0,0,89,6,6,0,0.206677266
1400000US17031832600,17031832600,"Census Tract 8326, Cook County, Illinois",4102,3852,3525,97,0,123,0,0,107,0,107,250,231,1,0,9,0,9,0,0,0,0.140663091
1400000US17031832900,17031832900,"Census Tract 8329, Cook County, Illinois",2347,2007,1475,45,0,420,0,0,67,0,67,340,188,0,0,14,0,109,29,29,0,0.371538134
1400000US17031833000,17031833000,"Census Tract 8330, Cook County, Illinois",2768,2705,2133,267,0,239,0,0,66,0,66,63,43,0,0,0,20,0,0,0,0,0.229407514
1400000US17031833100,17031833100,"Census Tract 8331, Cook County, Illinois",7417,6902,4669,992,0,1145,0,0,96,0,96,515,431,18,0,0,0,66,0,0,0,0.370500202
1400000US17031833300,17031833300,"Census Tract 8333, Cook County, Illinois",2442,2090,1243,218,0,595,0,0,34,8,26,352,253,0,0,11,0,65,23,23,0,0.490990991
1400000US17031833900,17031833900,"Census Tract 8339, Cook County, Illinois",2171,1049,15,1034,0,0,0,0,0,0,0,1122,747,26,0,0,0,330,19,19,0,0.993090742
1400000US17031834000,17031834000,"Census Tract 8340, Cook County, Illinois",3616,3569,0,3556,0,0,0,0,13,0,13,47,47,0,0,0,0,0,0,0,0,1
1400000US17031834200,17031834200,"Census Tract 8342, Cook County, Illinois",4298,4195,21,4158,0,0,0,0,16,0,16,103,76,27,0,0,0,0,0,0,0,0.995114007
1400000US17031834300,17031834300,"Census Tract 8343, Cook County, Illinois",6382,6338,46,6218,0,30,0,0,44,0,44,44,44,0,0,0,0,0,0,0,0,0.992792228
1400000US17031834400,17031834400,"Census Tract 8344, Cook County, Illinois",4197,4143,129,3832,0,25,0,0,157,0,157,54,16,29,9,0,0,0,0,0,0,0.96926376
1400000US17031834500,17031834500,"Census Tract 8345, Cook County, Illinois",1563,1490,0,1409,0,0,0,0,81,0,81,73,54,0,0,0,0,5,14,14,0,1
1400000US17031834600,17031834600,"Census Tract 8346, Cook County, Illinois",3010,2972,78,2873,0,10,0,0,11,0,11,38,0,24,0,0,0,14,0,0,0,0.974086379
1400000US17031834700,17031834700,"Census Tract 8347, Cook County, Illinois",2048,1921,5,1787,0,48,0,4,77,5,72,127,90,12,0,0,0,0,25,25,0,0.997558594
1400000US17031834800,17031834800,"Census Tract 8348, Cook County, Illinois",1833,1833,3,1814,0,11,0,0,5,0,5,0,0,0,0,0,0,0,0,0,0,0.998363339
1400000US17031834900,17031834900,"Census Tract 8349, Cook County, Illinois",2292,2274,14,2211,0,0,9,0,40,0,40,18,18,0,0,0,0,0,0,0,0,0.993891798
1400000US17031835000,17031835000,"Census Tract 8350, Cook County, Illinois",5811,3874,124,3704,0,29,0,0,17,0,17,1937,407,19,0,0,0,1475,36,36,0,0.97866116
1400000US17031835100,17031835100,"Census Tract 8351, Cook County, Illinois",5555,873,143,712,0,18,0,0,0,0,0,4682,2452,24,0,0,0,1973,233,106,127,0.974257426
1400000US17031835200,17031835200,"Census Tract 8352, Cook County, Illinois",1871,763,698,6,0,59,0,0,0,0,0,1108,527,0,4,0,0,567,10,10,0,0.626937467
1400000US17031835500,17031835500,"Census Tract 8355, Cook County, Illinois",1593,1407,35,1361,0,0,0,0,11,0,11,186,43,0,0,0,0,132,11,0,11,0.978028876
1400000US17031835600,17031835600,"Census Tract 8356, Cook County, Illinois",950,945,17,928,0,0,0,0,0,0,0,5,5,0,0,0,0,0,0,0,0,0.982105263
1400000US17031835700,17031835700,"Census Tract 8357, Cook County, Illinois",248,248,0,222,0,0,0,0,26,0,26,0,0,0,0,0,0,0,0,0,0,1
1400000US17031835800,17031835800,"Census Tract 8358, Cook County, Illinois",1469,1437,28,1388,0,21,0,0,0,0,0,32,14,6,0,0,0,0,12,0,12,0.980939415
1400000US17031835900,17031835900,"Census Tract 8359, Cook County, Illinois",3595,3554,16,3338,0,0,0,134,66,0,66,41,7,26,0,0,0,8,0,0,0,0.995549374
1400000US17031836000,17031836000,"Census Tract 8360, Cook County, Illinois",2663,2609,33,2472,0,16,0,0,88,9,79,54,0,0,0,0,0,54,0,0,0,0.987607961
1400000US17031836100,17031836100,"Census Tract 8361, Cook County, Illinois",1833,1700,11,1684,0,5,0,0,0,0,0,133,0,133,0,0,0,0,0,0,0,0.993998909
1400000US17031836200,17031836200,"Census Tract 8362, Cook County, Illinois",1590,1560,1041,123,5,346,0,5,40,5,35,30,24,0,0,0,0,6,0,0,0,0.345283019
1400000US17031836300,17031836300,"Census Tract 8363, Cook County, Illinois",1583,1538,431,923,0,82,0,50,52,0,52,45,28,0,0,0,0,17,0,0,0,0.727732154
1400000US17031836400,17031836400,"Census Tract 8364, Cook County, Illinois",3209,3139,123,2901,0,103,0,0,12,0,12,70,23,14,0,0,0,33,0,0,0,0.961670302
1400000US17031836500,17031836500,"Census Tract 8365, Cook County, Illinois",1648,1596,24,1572,0,0,0,0,0,0,0,52,52,0,0,0,0,0,0,0,0,0.985436893
1400000US17031836600,17031836600,"Census Tract 8366, Cook County, Illinois",2426,1061,344,717,0,0,0,0,0,0,0,1365,422,28,0,0,0,901,14,9,5,0.858202803
1400000US17031836700,17031836700,"Census Tract 8367, Cook County, Illinois",2598,1968,58,1910,0,0,0,0,0,0,0,630,192,67,0,0,0,371,0,0,0,0.977675135
1400000US17031836800,17031836800,"Census Tract 8368, Cook County, Illinois",2261,2184,36,2148,0,0,0,0,0,0,0,77,10,0,0,0,0,28,39,28,11,0.984077842
1400000US17031836900,17031836900,"Census Tract 8369, Cook County, Illinois",1553,1445,24,1407,0,14,0,0,0,0,0,108,60,0,0,0,0,48,0,0,0,0.98454604
1400000US17031837000,17031837000,"Census Tract 8370, Cook County, Illinois",2457,2343,96,2241,0,1,0,0,5,0,5,114,50,14,0,0,0,50,0,0,0,0.960927961
1400000US17031837100,17031837100,"Census Tract 8371, Cook County, Illinois",1939,1781,258,1456,0,0,0,7,60,15,45,158,71,0,0,0,0,61,26,0,26,0.866941723
1400000US17031837300,17031837300,"Census Tract 8373, Cook County, Illinois",2158,2038,92,1895,0,33,0,0,18,0,18,120,28,34,0,0,0,58,0,0,0,0.957367933
1400000US17031837400,17031837400,"Census Tract 8374, Cook County, Illinois",2034,2019,183,1825,0,11,0,0,0,0,0,15,15,0,0,0,0,0,0,0,0,0.910029499
1400000US17031837800,17031837800,"Census Tract 8378, Cook County, Illinois",3418,3087,429,2445,0,162,0,0,51,0,51,331,82,89,0,0,0,160,0,0,0,0.874488005
1400000US17031838000,17031838000,"Census Tract 8380, Cook County, Illinois",2861,2649,497,1938,0,124,0,50,40,0,40,212,75,10,28,0,0,71,28,28,0,0.826284516
1400000US17031838100,17031838100,"Census Tract 8381, Cook County, Illinois",1837,1738,490,921,0,282,0,0,45,0,45,99,34,15,0,0,0,50,0,0,0,0.733260751
1400000US17031838200,17031838200,"Census Tract 8382, Cook County, Illinois",1866,1515,749,435,0,293,0,0,38,20,18,351,270,13,0,0,0,49,19,10,9,0.598606645
1400000US17031838300,17031838300,"Census Tract 8383, Cook County, Illinois",1506,1276,428,780,0,65,0,0,3,0,3,230,173,0,0,0,0,57,0,0,0,0.715803453
1400000US17031838600,17031838600,"Census Tract 8386, Cook County, Illinois",1404,1383,27,1356,0,0,0,0,0,0,0,21,15,3,0,0,0,3,0,0,0,0.980769231
1400000US17031838700,17031838700,"Census Tract 8387, Cook County, Illinois",4891,4589,0,4456,0,0,0,133,0,0,0,302,214,88,0,0,0,0,0,0,0,1
1400000US17031838800,17031838800,"Census Tract 8388, Cook County, Illinois",3232,1844,171,1654,19,0,0,0,0,0,0,1388,1134,7,0,0,0,247,0,0,0,0.947091584
1400000US17031839000,17031839000,"Census Tract 8390, Cook County, Illinois",7868,7572,4734,1080,0,1418,0,0,340,7,333,296,239,6,0,0,0,51,0,0,0,0.398322318
1400000US17031839100,17031839100,"Census Tract 8391, Cook County, Illinois",5266,4814,3013,725,0,948,0,15,113,0,113,452,267,0,0,18,0,96,71,16,55,0.427838967
1400000US17031839200,17031839200,"Census Tract 8392, Cook County, Illinois",2191,2133,231,1624,0,232,0,9,37,0,37,58,46,0,0,0,0,12,0,0,0,0.89456869
1400000US17031839500,17031839500,"Census Tract 8395, Cook County, Illinois",1379,1341,246,967,0,109,0,0,19,0,19,38,6,0,6,0,0,22,4,0,4,0.821609862
1400000US17031839600,17031839600,"Census Tract 8396, Cook County, Illinois",1831,1821,217,1564,0,23,0,0,17,0,17,10,0,10,0,0,0,0,0,0,0,0.881485527
1400000US17031839700,17031839700,"Census Tract 8397, Cook County, Illinois",4794,2371,1054,145,0,997,0,117,58,0,58,2423,1194,0,10,0,0,1154,65,61,4,0.780141844
1400000US17031839800,17031839800,"Census Tract 8398, Cook County, Illinois",2653,1931,1132,26,0,724,0,34,15,0,15,722,451,0,0,0,0,271,0,0,0,0.57331323
1400000US17031839900,17031839900,"Census Tract 8399, Cook County, Illinois",3807,2949,2296,37,0,525,0,0,91,0,91,858,597,0,18,0,6,200,37,21,16,0.396900447
1400000US17031840000,17031840000,"Census Tract 8400, Cook County, Illinois",2650,2255,1311,0,0,852,0,0,92,10,82,395,82,15,0,0,0,282,16,16,0,0.505283019
1400000US17031840100,17031840100,"Census Tract 8401, Cook County, Illinois",2346,2038,583,0,0,1455,0,0,0,0,0,308,308,0,0,0,0,0,0,0,0,0.751491901
1400000US17031840200,17031840200,"Census Tract 8402, Cook County, Illinois",2589,1894,456,14,0,1412,0,6,6,0,6,695,475,0,0,0,0,207,13,5,8,0.82387022
1400000US17031840300,17031840300,"Census Tract 8403, Cook County, Illinois",4147,1599,583,95,103,818,0,0,0,0,0,2548,1302,13,52,10,0,978,193,34,159,0.859416446
1400000US17031840400,17031840400,"Census Tract 8404, Cook County, Illinois",3272,1976,857,141,0,978,0,0,0,0,0,1296,607,0,72,0,0,605,12,3,9,0.738080685
1400000US17031840700,17031840700,"Census Tract 8407, Cook County, Illinois",4070,423,269,114,0,28,0,0,12,0,12,3647,2697,14,28,0,0,860,48,48,0,0.933906634
1400000US17031840800,17031840800,"Census Tract 8408, Cook County, Illinois",3419,84,34,10,0,23,0,5,12,0,12,3335,2677,0,38,0,0,549,71,59,12,0.990055572
1400000US17031841000,17031841000,"Census Tract 8410, Cook County, Illinois",683,683,116,349,0,173,0,0,45,0,45,0,0,0,0,0,0,0,0,0,0,0.830161054
1400000US17031841100,17031841100,"Census Tract 8411, Cook County, Illinois",7622,7585,338,302,0,6691,0,0,254,0,254,37,20,0,0,0,0,0,17,0,17,0.955654684
1400000US17031841200,17031841200,"Census Tract 8412, Cook County, Illinois",5685,760,482,256,0,22,0,0,0,0,0,4925,2418,29,0,0,0,2409,69,43,26,0.915215479
1400000US17031841300,17031841300,"Census Tract 8413, Cook County, Illinois",4221,636,370,161,0,15,0,0,90,0,90,3585,1713,0,0,0,0,1713,159,34,125,0.912343047
1400000US17031841400,17031841400,"Census Tract 8414, Cook County, Illinois",1309,1169,59,1106,0,4,0,0,0,0,0,140,40,40,0,0,0,28,32,32,0,0.954927426
1400000US17031841500,17031841500,"Census Tract 8415, Cook County, Illinois",2672,2529,16,2474,0,12,0,8,19,0,19,143,35,0,0,0,0,108,0,0,0,0.994011976
1400000US17031841600,17031841600,"Census Tract 8416, Cook County, Illinois",817,817,6,811,0,0,0,0,0,0,0,0,0,0,0,0,0,0,0,0,0,0.992656059
1400000US17031841700,17031841700,"Census Tract 8417, Cook County, Illinois",1613,982,33,936,0,0,0,0,13,0,13,631,432,0,0,0,0,199,0,0,0,0.979541228
1400000US17031841800,17031841800,"Census Tract 8418, Cook County, Illinois",2646,2507,0,2337,0,0,0,11,159,0,159,139,8,130,0,0,0,1,0,0,0,1
1400000US17031841900,17031841900,"Census Tract 8419, Cook County, Illinois",5774,4899,2789,842,0,998,0,12,258,7,251,875,559,86,0,5,0,148,77,32,45,0.516972636
1400000US17031842000,17031842000,"Census Tract 8420, Cook County, Illinois",3017,2824,1192,1027,0,523,0,0,82,13,69,193,155,5,0,8,0,24,1,1,0,0.604905535
1400000US17031842100,17031842100,"Census Tract 8421, Cook County, Illinois",6573,3966,47,3864,55,0,0,0,0,0,0,2607,889,169,0,0,0,1383,166,166,0,0.992849536
1400000US17031842200,17031842200,"Census Tract 8422, Cook County, Illinois",2344,2054,1253,493,0,231,0,0,77,6,71,290,203,4,0,0,0,83,0,0,0,0.465443686
1400000US17031842300,17031842300,"Census Tract 8423, Cook County, Illinois",3499,3270,2558,433,0,178,0,5,96,0,96,229,198,0,0,0,0,31,0,0,0,0.268933981
1400000US17031842400,17031842400,"Census Tract 8424, Cook County, Illinois",3374,3374,0,3374,0,0,0,0,0,0,0,0,0,0,0,0,0,0,0,0,0,1
1400000US17031842500,17031842500,"Census Tract 8425, Cook County, Illinois",2375,2371,2,2369,0,0,0,0,0,0,0,4,0,0,0,0,0,4,0,0,0,0.999157895
1400000US17031842600,17031842600,"Census Tract 8426, Cook County, Illinois",4988,3195,2478,147,0,476,0,0,94,10,84,1793,1294,0,0,0,0,462,37,7,30,0.503207698
1400000US17031842800,17031842800,"Census Tract 8428, Cook County, Illinois",7638,892,420,74,16,369,0,13,0,0,0,6746,3524,0,13,0,0,3061,148,129,19,0.945011783
1400000US17031842900,17031842900,"Census Tract 8429, Cook County, Illinois",2246,1909,136,1737,0,36,0,0,0,0,0,337,31,24,8,0,0,244,30,21,9,0.939447907
1400000US17031843000,17031843000,"Census Tract 8430, Cook County, Illinois",3138,3071,0,3064,7,0,0,0,0,0,0,67,7,14,0,0,0,46,0,0,0,1
1400000US17031843100,17031843100,"Census Tract 8431, Cook County, Illinois",2273,2172,123,1976,0,28,0,0,45,5,40,101,5,0,0,0,0,91,5,5,0,0.945886494
1400000US17031843200,17031843200,"Census Tract 8432, Cook County, Illinois",2725,388,310,35,5,20,0,0,18,0,18,2337,1033,9,0,0,0,1275,20,20,0,0.886238532
1400000US17031843300,17031843300,"Census Tract 8433, Cook County, Illinois",1772,1056,92,941,0,6,0,10,7,7,0,716,487,25,0,0,0,203,1,0,1,0.948081264
1400000US17031843400,17031843400,"Census Tract 8434, Cook County, Illinois",1460,1413,6,1297,0,31,0,0,79,0,79,47,36,11,0,0,0,0,0,0,0,0.995890411
1400000US17031843500,17031843500,"Census Tract 8435, Cook County, Illinois",8881,6874,873,5969,6,26,0,0,0,0,0,2007,1707,24,0,0,0,276,0,0,0,0.901700259
1400000US17031843600,17031843600,"Census Tract 8436, Cook County, Illinois",2609,2557,53,2476,0,21,0,0,7,0,7,52,8,14,0,9,0,21,0,0,0,0.979685703
1400000US17031843700,17031843700,"Census Tract 8437, Cook County, Illinois",2279,1869,1677,21,8,93,0,8,62,0,62,410,377,0,0,0,0,18,15,15,0,0.264150943
1400000US17031843800,17031843800,"Census Tract 8438, Cook County, Illinois",1856,1443,368,910,0,147,0,0,18,0,18,413,307,11,0,0,0,95,0,0,0,0.801724138
1400000US17031843900,17031843900,"Census Tract 8439, Cook County, Illinois",3628,3420,46,3293,0,72,0,0,9,0,9,208,44,36,0,27,0,92,9,9,0,0.987320838
1400000US17031980000,17031980000,"Census Tract 9800, Cook County, Illinois",0,0,0,0,0,0,0,0,0,0,0,0,0,0,0,0,0,0,0,0,0,
1400000US17031980100,17031980100,"Census Tract 9801, Cook County, Illinois",0,0,0,0,0,0,0,0,0,0,0,0,0,0,0,0,0,0,0,0,0,
1400000US17031990000,17031990000,"Census Tract 9900, Cook County, Illinois",0,0,0,0,0,0,0,0,0,0,0,0,0,0,0,0,0,0,0,0,0,
